"tenfoot"
{
"UI_Submit"	"Υποβολή"
"[english]UI_Submit"	"Submit"
"UI_Select"	"ΕΠΙΛΟΓΗ"
"[english]UI_Select"	"Select"
"UI_Inspect"	"Επιθεώρηση"
"[english]UI_Inspect"	"Inspect"
"UI_LeftStick_Short"	"LS"
"[english]UI_LeftStick_Short"	"LS"
"UI_RightStick_Short"	"RS"
"[english]UI_RightStick_Short"	"RS"
"UI_LeftTrigger_Short"	"LT"
"[english]UI_LeftTrigger_Short"	"LT"
"UI_RightTrigger_Short"	"RT"
"[english]UI_RightTrigger_Short"	"RT"
"UI_LeftBumper_Short"	"LB"
"[english]UI_LeftBumper_Short"	"LB"
"UI_RightBumper_Short"	"RB"
"[english]UI_RightBumper_Short"	"RB"
"UI_LeftBack_Short"	"ΑP"
"[english]UI_LeftBack_Short"	"LP"
"UI_RightBack_Short"	"ΔP"
"[english]UI_RightBack_Short"	"RP"
"UI_AButton"	"Α"
"[english]UI_AButton"	"A"
"UI_BButton"	"Β"
"[english]UI_BButton"	"B"
"UI_XButton"	"Χ"
"[english]UI_XButton"	"X"
"UI_YButton"	"Y"
"[english]UI_YButton"	"Y"
"UI_Cancel"	"Άκυρο"
"[english]UI_Cancel"	"CANCEL"
"UI_Dismiss"	"ΑΠΟΡΡΙΨΗ"
"[english]UI_Dismiss"	"DISMISS"
"UI_Submit_Caps"	"Υποβολή"
"[english]UI_Submit_Caps"	"SUBMIT"
"UI_OK"	"OK"
"[english]UI_OK"	"OK"
"UI_Done"	"ΟΚ"
"[english]UI_Done"	"DONE"
"UI_Back"	"Πίσω"
"[english]UI_Back"	"BACK"
"UI_Yes"	"Ναι"
"[english]UI_Yes"	"YES"
"UI_No"	"Όχι"
"[english]UI_No"	"NO"
"UI_Unknown"	"Άγνωστος"
"[english]UI_Unknown"	"UNKNOWN"
"UI_Always"	"ΠΑΝΤΑ"
"[english]UI_Always"	"ALWAYS"
"UI_Select_Footer"	"ΕΠΙΛΟΓΗ"
"[english]UI_Select_Footer"	"SELECT"
"UI_Cancel_Footer"	"Άκυρο"
"[english]UI_Cancel_Footer"	"CANCEL"
"UI_Back_Footer"	"Πίσω"
"[english]UI_Back_Footer"	"BACK"
"UI_Alert"	"Ειδοποίηση"
"[english]UI_Alert"	"Alert"
"UI_Backspace"	"BACKSPACE"
"[english]UI_Backspace"	"BACKSPACE"
"UI_Spacebar"	"ΔΙΑΣΤΗΜΑ"
"[english]UI_Spacebar"	"SPACE"
"UI_MoveCaret"	"ΜΕΤΑΚΙΝΗΣΗ ΚΕΡΣΟΡΑ"
"[english]UI_MoveCaret"	"MOVE CURSOR"
"UI_MoveCaretLeft"	"« ΚΕΡΣΟΡΑΣ"
"[english]UI_MoveCaretLeft"	"« CURSOR"
"UI_MoveCaretRight"	"ΚΕΡΣΟΡΑΣ »"
"[english]UI_MoveCaretRight"	"CURSOR »"
"UI_InputDone"	"ΟΚ"
"[english]UI_InputDone"	"DONE"
"UI_MoreOptions"	"ΠΕΡΙΣΣΟΤΕΡΕΣ ΕΠΙΛΟΓΕΣ"
"[english]UI_MoreOptions"	"MORE OPTIONS"
"UI_SendMessage"	"ΑΠΟΣΤΟΛΗ"
"[english]UI_SendMessage"	"SEND"
"UI_Languages"	"ΓΛΩΣΣΕΣ"
"[english]UI_Languages"	"LANGUAGES"
"UI_Next"	"ΕΠΟΜΕΝΟ"
"[english]UI_Next"	"NEXT"
"UI_Today"	"Σήμερα"
"[english]UI_Today"	"Today"
"UI_Yesterday"	"Χθες"
"[english]UI_Yesterday"	"Yesterday"
"UI_Tomorrow"	"Αύριο"
"[english]UI_Tomorrow"	"Tomorrow"
"UI_Hours"	"ώρες"
"[english]UI_Hours"	"hours"
"UI_Minutes"	"λεπτά"
"[english]UI_Minutes"	"minutes"
"UI_Seconds"	"δευτερόλεπτα"
"[english]UI_Seconds"	"seconds"
"UI_Hour"	"ώρα"
"[english]UI_Hour"	"hour"
"UI_Minute"	"λεπτό"
"[english]UI_Minute"	"minute"
"UI_Second"	"δευτερόλεπτο"
"[english]UI_Second"	"second"
"UI_UnknownTime"	"Άγνωστος"
"[english]UI_UnknownTime"	"Unknown"
"UI_Label_CopySelected"	"Αντιγραφή επιλεγμένου κειμένου"
"[english]UI_Label_CopySelected"	"Copy selected text"
"UI_Label_OpenLinkInBrowser"	"Άνοιγμα URL στον περιηγητή"
"[english]UI_Label_OpenLinkInBrowser"	"Open URL in browser"
"UI_Label_CopyURLToClipboard"	"Αντιγραφή URL"
"[english]UI_Label_CopyURLToClipboard"	"Copy URL to clipboard"
"UI_TextEntry_CutToClipboard"	"Αποκοπή"
"[english]UI_TextEntry_CutToClipboard"	"Cut"
"UI_TextEntry_CopyToClipboard"	"Αντιγραφή"
"[english]UI_TextEntry_CopyToClipboard"	"Copy"
"UI_TextEntry_PasteClipboard"	"Επικόλληση"
"[english]UI_TextEntry_PasteClipboard"	"Paste"
"UI_Agreements"	"Συμφωνητικά"
"[english]UI_Agreements"	"Agreements"
"UI_ViewAgreements"	"ΣΥΜΦΩΝΗΤΙΚΟ ΣΥΝΔΡΟΜΗΤΗ STEAM ΚΑΙ ΠΟΛΙΤΙΚΗ ΑΠΟΡΡΗΤΟΥ"
"[english]UI_ViewAgreements"	"VIEW SSA & PRIVACY POLICY"
"UI_I_Agree"	"Συμφωνώ"
"[english]UI_I_Agree"	"I agree"
"Month_January"	"Ιανουάριος"
"[english]Month_January"	"January"
"Month_February"	"Φεβρουάριος"
"[english]Month_February"	"February"
"Month_March"	"Μάρτιος"
"[english]Month_March"	"March"
"Month_April"	"Απρίλιος"
"[english]Month_April"	"April"
"Month_May"	"Μάιος"
"[english]Month_May"	"May"
"Month_June"	"Ιούνιος"
"[english]Month_June"	"June"
"Month_July"	"Ιούλιος"
"[english]Month_July"	"July"
"Month_August"	"Αύγουστος"
"[english]Month_August"	"August"
"Month_September"	"Σεπτέμβριος"
"[english]Month_September"	"September"
"Month_October"	"Οκτώβριος"
"[english]Month_October"	"October"
"Month_November"	"Νοέμβριος"
"[english]Month_November"	"November"
"Month_December"	"Δεκέμβριος"
"[english]Month_December"	"December"
"UI_Continue"	"Συνέχεια"
"[english]UI_Continue"	"Continue"
"UI_Age_Gate_Continue"	"ΣΥΝΕΧΕΙΑ"
"[english]UI_Age_Gate_Continue"	"CONTINUE"
"Panorama_Lang_English"	"Αγγλικά"
"[english]Panorama_Lang_English"	"English"
"Panorama_Lang_Spanish"	"ΙΣΠΑΝΙΚΑ"
"[english]Panorama_Lang_Spanish"	"Spanish"
"Panorama_Lang_French"	"ΓΑΛΛΙΚΑ"
"[english]Panorama_Lang_French"	"French"
"Panorama_Lang_Italian"	"ΙΤΑΛΙΚΑ"
"[english]Panorama_Lang_Italian"	"Italian"
"Panorama_Lang_German"	"ΓΕΡΜΑΝΙΚΑ"
"[english]Panorama_Lang_German"	"German"
"Panorama_Lang_Greek"	"ΕΛΛΗΝΙΚΑ"
"[english]Panorama_Lang_Greek"	"Greek"
"Panorama_Lang_Korean"	"ΚΟΡΕΑΤΙΚΑ"
"[english]Panorama_Lang_Korean"	"Korean"
"Panorama_Lang_Simplified_Chinese"	"Απλοποιημένα Κινεζικά"
"[english]Panorama_Lang_Simplified_Chinese"	"Simplified Chinese"
"Panorama_Lang_Traditional_Chinese"	"Παραδοσιακά Κινεζικά"
"[english]Panorama_Lang_Traditional_Chinese"	"Traditional Chinese"
"Panorama_Lang_Russian"	"ΡΩΣΙΚΑ"
"[english]Panorama_Lang_Russian"	"Russian"
"Panorama_Lang_Thai"	"ΤΑΙΛΑΝΔΕΖΙΚΑ"
"[english]Panorama_Lang_Thai"	"Thai"
"Panorama_Lang_Japanese"	"ΙΑΠΩΝΙΚΑ"
"[english]Panorama_Lang_Japanese"	"Japanese"
"Panorama_Lang_Portuguese"	"ΠΟΡΤΟΓΑΛΙΚΑ"
"[english]Panorama_Lang_Portuguese"	"Portuguese"
"Panorama_Lang_Brazilian"	"Πορτογαλικά-Βραζιλίας"
"[english]Panorama_Lang_Brazilian"	"Portuguese-Brazil"
"Panorama_Lang_Polish"	"ΠΟΛΩΝΙΚΑ"
"[english]Panorama_Lang_Polish"	"Polish"
"Panorama_Lang_Danish"	"Δανικά"
"[english]Panorama_Lang_Danish"	"Danish"
"Panorama_Lang_Dutch"	"Ολλανδικά"
"[english]Panorama_Lang_Dutch"	"Dutch"
"Panorama_Lang_Finnish"	"Φινλανδικά"
"[english]Panorama_Lang_Finnish"	"Finnish"
"Panorama_Lang_Norwegian"	"ΝΟΡΒΗΓΙΚΑ"
"[english]Panorama_Lang_Norwegian"	"Norwegian"
"Panorama_Lang_Swedish"	"ΣΟΥΗΔΙΚΑ"
"[english]Panorama_Lang_Swedish"	"Swedish"
"Panorama_Lang_Czech"	"Τσεχικά"
"[english]Panorama_Lang_Czech"	"Czech"
"Panorama_Lang_Hungarian"	"ΟΥΓΓΡΙΚΑ"
"[english]Panorama_Lang_Hungarian"	"Hungarian"
"Panorama_Lang_Romanian"	"ΡΟΥΜΑΝΙΚΑ"
"[english]Panorama_Lang_Romanian"	"Romanian"
"Panorama_Lang_Bulgarian"	"Βουλγαρικά"
"[english]Panorama_Lang_Bulgarian"	"Bulgarian"
"Panorama_Lang_Turkish"	"ΤΟΥΡΚΙΚΑ"
"[english]Panorama_Lang_Turkish"	"Turkish"
"Panorama_Lang_Arabic"	"Αραβικά"
"[english]Panorama_Lang_Arabic"	"Arabic"
"Panorama_Lang_Ukrainian"	"ΟΥΚΡΑΝΙΚΑ"
"[english]Panorama_Lang_Ukrainian"	"Ukrainian"
"Panorama_Lang_Footer_English"	"Αγγλικά"
"[english]Panorama_Lang_Footer_English"	"ENGLISH"
"Panorama_Lang_Footer_Spanish"	"ΙΣΠΑΝΙΚΑ"
"[english]Panorama_Lang_Footer_Spanish"	"SPANISH"
"Panorama_Lang_Footer_French"	"ΓΑΛΛΙΚΑ"
"[english]Panorama_Lang_Footer_French"	"FRENCH"
"Panorama_Lang_Footer_Italian"	"ΙΤΑΛΙΚΑ"
"[english]Panorama_Lang_Footer_Italian"	"ITALIAN"
"Panorama_Lang_Footer_German"	"ΓΕΡΜΑΝΙΚΑ"
"[english]Panorama_Lang_Footer_German"	"GERMAN"
"Panorama_Lang_Footer_Greek"	"ΕΛΛΗΝΙΚΑ"
"[english]Panorama_Lang_Footer_Greek"	"GREEK"
"Panorama_Lang_Footer_Korean"	"ΚΟΡΕΑΤΙΚΑ"
"[english]Panorama_Lang_Footer_Korean"	"KOREAN"
"Panorama_Lang_Footer_Simplified_Chinese"	"ΑΠΛ ΚΙΝΕΖΙΚΑ"
"[english]Panorama_Lang_Footer_Simplified_Chinese"	"SIM CHINESE"
"Panorama_Lang_Footer_Traditional_Chinese"	"ΠΑΡΑΔ ΚΙΝΕΖΙΚΑ"
"[english]Panorama_Lang_Footer_Traditional_Chinese"	"TRAD CHINESE"
"Panorama_Lang_Footer_Russian"	"ΡΩΣΙΚΑ"
"[english]Panorama_Lang_Footer_Russian"	"RUSSIAN"
"Panorama_Lang_Footer_Thai"	"ΤΑΪΛΑΝΔΕΖΙΚΑ"
"[english]Panorama_Lang_Footer_Thai"	"THAI"
"Panorama_Lang_Footer_Japanese"	"ΙΑΠΩΝΙΚΑ"
"[english]Panorama_Lang_Footer_Japanese"	"JAPANESE"
"Panorama_Lang_Footer_Portuguese"	"ΠΟΡΤΟΓΑΛΙΚΑ"
"[english]Panorama_Lang_Footer_Portuguese"	"PORTUGUESE"
"Panorama_Lang_Footer_Brazilian"	"ΠΟΡΤΟΓΑΛΙΚΑ-Β"
"[english]Panorama_Lang_Footer_Brazilian"	"PORTUGUESE-B"
"Panorama_Lang_Footer_Polish"	"ΠΟΛΩΝΙΚΑ"
"[english]Panorama_Lang_Footer_Polish"	"POLISH"
"Panorama_Lang_Footer_Danish"	"ΔΑΝΙΚΑ"
"[english]Panorama_Lang_Footer_Danish"	"DANISH"
"Panorama_Lang_Footer_Dutch"	"ΟΛΛΑΝΔΙΚΑ"
"[english]Panorama_Lang_Footer_Dutch"	"DUTCH"
"Panorama_Lang_Footer_Finnish"	"ΦΙΝΛΑΝΔΙΚΑ"
"[english]Panorama_Lang_Footer_Finnish"	"FINNISH"
"Panorama_Lang_Footer_Norwegian"	"ΝΟΡΒΗΓΙΚΑ"
"[english]Panorama_Lang_Footer_Norwegian"	"NORWEGIAN"
"Panorama_Lang_Footer_Swedish"	"ΣΟΥΗΔΙΚΑ"
"[english]Panorama_Lang_Footer_Swedish"	"SWEDISH"
"Panorama_Lang_Footer_Czech"	"ΤΣΕΧΙΚΑ"
"[english]Panorama_Lang_Footer_Czech"	"CZECH"
"Panorama_Lang_Footer_Hungarian"	"ΟΥΓΓΡΙΚΑ"
"[english]Panorama_Lang_Footer_Hungarian"	"HUNGARIAN"
"Panorama_Lang_Footer_Romanian"	"ΡΟΥΜΑΝΙΚΑ"
"[english]Panorama_Lang_Footer_Romanian"	"ROMANIAN"
"Panorama_Lang_Footer_Bulgarian"	"ΒΟΥΛΓΑΡΙΚΑ"
"[english]Panorama_Lang_Footer_Bulgarian"	"BULGARIAN"
"Panorama_Lang_Footer_Turkish"	"ΤΟΥΡΚΙΚΑ"
"[english]Panorama_Lang_Footer_Turkish"	"TURKISH"
"Panorama_Lang_Footer_Ukrainian"	"ΟΥΚΡΑΝΙΚΑ"
"[english]Panorama_Lang_Footer_Ukrainian"	"UKRAINIAN"
"Panorama_Selection_English"	"Αγγλικά"
"[english]Panorama_Selection_English"	"English"
"Panorama_Selection_Spanish"	"Español (Ισπανικά)"
"[english]Panorama_Selection_Spanish"	"Español (Spanish)"
"Panorama_Selection_French"	"Français (Γαλλικά)"
"[english]Panorama_Selection_French"	"Français (French)"
"Panorama_Selection_Italian"	"Italiano (Ιταλικά)"
"[english]Panorama_Selection_Italian"	"Italiano (Italian)"
"Panorama_Selection_German"	"Deutsch (Γερμανικά)"
"[english]Panorama_Selection_German"	"Deutsch (German)"
"Panorama_Selection_Greek"	"Ελληνικά (Greek)"
"[english]Panorama_Selection_Greek"	"Ελληνικά (Greek)"
"Panorama_Selection_Korean"	"한국어 (Κορεάτικα)"
"[english]Panorama_Selection_Korean"	"한국어 (Korean)"
"Panorama_Selection_Simplified_Chinese"	"简体中文 (Απλοποιημένα Κινέζικα)"
"[english]Panorama_Selection_Simplified_Chinese"	"简体中文 (Simplified Chinese)"
"Panorama_Selection_Traditional_Chinese"	"繁體中文 (Παραδοσιακά Κινέζικα)"
"[english]Panorama_Selection_Traditional_Chinese"	"繁體中文 (Traditional Chinese)"
"Panorama_Selection_Russian"	"Русский (Ρώσικα)"
"[english]Panorama_Selection_Russian"	"Русский (Russian)"
"Panorama_Selection_Thai"	"ไทย (Ταϊλανδικά)"
"[english]Panorama_Selection_Thai"	"ไทย (Thai)"
"Panorama_Selection_Japanese"	"日本語 (Ιαπωνικά)"
"[english]Panorama_Selection_Japanese"	"日本語 (Japanese)"
"Panorama_Selection_Portuguese"	"Português (Πορτογαλικά)"
"[english]Panorama_Selection_Portuguese"	"Português (Portuguese)"
"Panorama_Selection_Brazilian"	"Português-Brasil (Πορτογαλικά-Βραζιλία)"
"[english]Panorama_Selection_Brazilian"	"Português-Brasil (Portuguese-Brazil)"
"Panorama_Selection_Polish"	"Polski (Πολωνικά)"
"[english]Panorama_Selection_Polish"	"Polski (Polish)"
"Panorama_Selection_Danish"	"Dansk (Δανικά)"
"[english]Panorama_Selection_Danish"	"Dansk (Danish)"
"Panorama_Selection_Dutch"	"Nederlands (Ολλανδικά)"
"[english]Panorama_Selection_Dutch"	"Nederlands (Dutch)"
"Panorama_Selection_Finnish"	"Suomi (Φινλανδικά)"
"[english]Panorama_Selection_Finnish"	"Suomi (Finnish)"
"Panorama_Selection_Norwegian"	"Norsk (Νορβηγικά)"
"[english]Panorama_Selection_Norwegian"	"Norsk (Norwegian)"
"Panorama_Selection_Swedish"	"Svenska (Σουηδικά)"
"[english]Panorama_Selection_Swedish"	"Svenska (Swedish)"
"Panorama_Selection_Czech"	"čeština (Τσέχικα)"
"[english]Panorama_Selection_Czech"	"čeština (Czech)"
"Panorama_Selection_Hungarian"	"Magyar (Ουγγρικά)"
"[english]Panorama_Selection_Hungarian"	"Magyar (Hungarian)"
"Panorama_Selection_Romanian"	"Română (Ρουμάνικα)"
"[english]Panorama_Selection_Romanian"	"Română (Romanian)"
"Panorama_Selection_Bulgarian"	"Български (Βουλγάρικα)"
"[english]Panorama_Selection_Bulgarian"	"Български (Bulgarian)"
"Panorama_Selection_Turkish"	"Türkçe (Τούρκικα)"
"[english]Panorama_Selection_Turkish"	"Türkçe (Turkish)"
"Panorama_Selection_Arabic"	"العربية (Αραβικά)"
"[english]Panorama_Selection_Arabic"	"العربية(Arabic)"
"Panorama_Selection_Ukrainian"	"Українська (Ουκρανικά)"
"[english]Panorama_Selection_Ukrainian"	"Українська (Ukrainian)"
"Panorama_MoviePlaybackError"	"Παρουσιάστηκε ένα σφάλμα κατά την αναπαραγωγή"
"[english]Panorama_MoviePlaybackError"	"An error ocurred during playback"
"Debugger_PaintInfo"	"Εμφάνιση πληροφοριών απεικόνισης"
"[english]Debugger_PaintInfo"	"Show Paint Info"
"Debugger_Style"	"Στυλ"
"[english]Debugger_Style"	"Style"
"Debugger_Computed"	"Υπολογίστηκε"
"[english]Debugger_Computed"	"Computed"
"Debugger_Measurements"	"Μετρήσεις:"
"[english]Debugger_Measurements"	"Measurements:"
"Debugger_Misc"	"Λοιπά:"
"[english]Debugger_Misc"	"Misc:"
"Debugger_Properties"	"Ιδιότητες:"
"[english]Debugger_Properties"	"Properties:"
"Debugger_StyleFileLink"	"{s:stylefile}"
"[english]Debugger_StyleFileLink"	"{s:stylefile}"
"Debugger_LayoutFileLink"	"{s:layoutfile}"
"[english]Debugger_LayoutFileLink"	"{s:layoutfile}"
"Debugger_LayoutFileLink_Code"	"Από XML/κώδικα"
"[english]Debugger_LayoutFileLink_Code"	"From XML/Code"
"Debugger_InheritedStyleHeader"	"Κληρονομήθηκε από"
"[english]Debugger_InheritedStyleHeader"	"Inherited from "
"Debugger_Save"	"Αποθήκευση αλλαγών"
"[english]Debugger_Save"	"Save All Changes"
"Debugger_Revert"	"Επαναφορά αλλαγών"
"[english]Debugger_Revert"	"Revert All Changes"
"Debugger_PanelStyleInvalid"	"Η εμφάνιση αλλάζει κατά την επεξεργασία! Πατήστε F5 για να ανανεώσετε την τρέχουσα εμφάνιση"
"[english]Debugger_PanelStyleInvalid"	"Styles changed while editing! Hit F5 to reload displayed styles"
"Debugger_AnimationHeader"	"Animation Keyframes"
"[english]Debugger_AnimationHeader"	"Animation Keyframes"
"Debugger_DevInfo"	"Προβολή πληροφοριών δημιουργού"
"[english]Debugger_DevInfo"	"Show Dev Info"
"Time"	"10:08"
"[english]Time"	"10:08"
"Time_Suffix"	"ΜΜ"
"[english]Time_Suffix"	"PM"
"Now_Playing"	"ΤΩΡΑ ΠΑΙΖΕΙ"
"[english]Now_Playing"	"NOW PLAYING"
"Now_Quitting"	"ΓΙΝΕΤΑΙ ΕΞΟΔΟΣ"
"[english]Now_Quitting"	"NOW EXITING"
"Quit"	"ΕΞΟΔΟΣ"
"[english]Quit"	"EXIT"
"App_Title"	"{s:current_app_name}"
"[english]App_Title"	"{s:current_app_name}"
"Menu_HTCVive"	"RE Vive"
"[english]Menu_HTCVive"	"RE Vive"
"Menu_HTCPhone"	"Τηλέφωνο"
"[english]Menu_HTCPhone"	"Phone"
"Menu_Steam"	"STEAM"
"[english]Menu_Steam"	"Steam"
"Menu_Browser"	"ΙΣΤΟΣ"
"[english]Menu_Browser"	"Web"
"Menu_Friends"	"Φίλοι"
"[english]Menu_Friends"	"Friends"
"Notifications_Header"	"ΝΕΑ"
"[english]Notifications_Header"	"NEW"
"VRHome_Header"	"ΕΠΙΣΤΡΟΦΗ ΣΤΗΝ ΑΡΧΙΚΗ"
"[english]VRHome_Header"	"RETURN TO HOME"
"Camera_Header"	"ΠΡΟΒΟΛΗ ΔΩΜΑΤΙΟΥ"
"[english]Camera_Header"	"ROOM VIEW"
"Settings_Header"	"ΡΥΘΜΙΣΕΙΣ"
"[english]Settings_Header"	"SETTINGS"
"Quit_Header"	"ΕΞΟΔΟΣ"
"[english]Quit_Header"	"QUIT"
"DashboardClose_Header"	"ΚΛΕΙΣΙΜΟ"
"[english]DashboardClose_Header"	"CLOSE"
"Battery_Status"	"ΧΕΙΡΙΣΤΗΡΙΑ"
"[english]Battery_Status"	"CONTROLLERS"
"Volume_Status"	"ΕΝΤΑΣΗ"
"[english]Volume_Status"	"VOLUME"
"Gamepad_Tip"	"Πλοήγηση στην μπάρα"
"[english]Gamepad_Tip"	"Navigate Dashboard"
"Battery1_Status"	"Μπαταρία 1"
"[english]Battery1_Status"	"Battery1"
"Battery2_Status"	"Μπαταρία 2"
"[english]Battery2_Status"	"Battery2"
"VR_Status"	"ΚΑΤΑΣΤΑΣΗ VR"
"[english]VR_Status"	"VR STATUS"
"VR_Notification_Title_Dashboard"	"Πρόσβαση στην μπάρα"
"[english]VR_Notification_Title_Dashboard"	"Access the Dashboard"
"VR_Notification_Content_Dashboard"	"Πατήστε το κουμπί συστήματος για να ξεκινήσετε"
"[english]VR_Notification_Content_Dashboard"	"Press the System Button to begin"
"VRSettings"	"Ρυθμίσεις SteamVR"
"[english]VRSettings"	"SteamVR Settings"
"NotificationsHeader"	"Ειδοποιήσεις"
"[english]NotificationsHeader"	"Notifications"
"NotificationsDesc"	"Όταν είναι ενεργοποιημένη η επιλογή «Μην ενοχλείτε», οι εισερχόμενες ειδοποιήσεις θα αποκρύπτονται."
"[english]NotificationsDesc"	"When Do Not Disturb is enabled, incoming notifications will be suppressed."
"NotificationsCheck"	"Μην ενοχλείτε"
"[english]NotificationsCheck"	"Do Not Disturb"
"HomeHeader"	"Εφαρμογή έναρξης"
"[english]HomeHeader"	"Startup Application"
"HomeDesc"	"Προσαρμόστε την εμπειρία έναρξής σας."
"[english]HomeDesc"	"Customize your startup experience."
"CurrentHome"	"HomeApp"
"[english]CurrentHome"	"HomeApp"
"SetCurrentApp"	"Έναρξη με {s:current_app_name}"
"[english]SetCurrentApp"	"Startup with {s:current_app_name}"
"Microphone_Status"	"Μικρόφωνο"
"[english]Microphone_Status"	"Microphone"
"OverlaysHeader"	"Επικαλύψεις μπάρας"
"[english]OverlaysHeader"	"Dashboard Overlays"
"OverlaysDesc"	"Επιλέξτε τις επικαλύψεις που θα είναι ενεργές στην μπάρα."
"[english]OverlaysDesc"	"Select Overlays to remain active in the Dashboard."
"OverlaysBrowse"	"Περιηγηθείτε στις διαθέσιμες επικαλύψεις στο Κατάστημα Steam"
"[english]OverlaysBrowse"	"Browse available Overlays in the Steam Store"
"Now_Starting"	"ΕΠΟΜΕΝΟ"
"[english]Now_Starting"	"NEXT UP"
"Next_App_Name"	"{s:starting_app_name}"
"[english]Next_App_Name"	"{s:starting_app_name}"
"HomeAppNone"	"Καθόλου"
"[english]HomeAppNone"	"None"
"HomeAppError"	"Σφάλμα: Μη έγκυρη εφαρμογή"
"[english]HomeAppError"	"Error: Invalid App"
"IPD_Description"	"Απόσταση \nμεταξύ φακών"
"[english]IPD_Description"	"Distance \nbetween lenses"
"IPD_Setting"	"{s:physical_ipd_mm} χιλιοστά"
"[english]IPD_Setting"	"{s:physical_ipd_mm}mm"
"SeatedSetupHeader"	"Ρύθμιση καθιστής θέσης"
"[english]SeatedSetupHeader"	"Seated Position Setup"
"SeatedSetupButton"	"Επαναφορά καθιστής θέσης"
"[english]SeatedSetupButton"	"Reset Seated Position"
"SeatedSetupStatus"	"Για να επαναφέρετε την καθιστή θέση σας, κοιτάξτε προς τα εμπρός σε μια χαλαρή καθιστή θέση και πατήστε το παραπάνω κουμπί."
"[english]SeatedSetupStatus"	"To reset your seated position, face forward in a relaxed sitting position and press the button above."
"PromptCancelQuestion"	"Θέλετε σίγουρα να κλείσετε το {s:current_app_name};"
"[english]PromptCancelQuestion"	"Are you sure you want to exit {s:current_app_name}?"
"PromptCancelInfo"	"Μπορεί να χάσετε πρόοδο αν δεν έχετε κάνει αποθήκευση."
"[english]PromptCancelInfo"	"You may lose progress if you haven't saved."
"PromptCancelTransition"	"Άκυρο"
"[english]PromptCancelTransition"	"Cancel"
"PromptQuitAnyway"	"Έξοδος"
"[english]PromptQuitAnyway"	"Exit Anyway"
"PowerMenuViewRoom"	"Εναλλαγή προβολής δωματίου"
"[english]PowerMenuViewRoom"	"Toggle Room View"
"PowerMenuResetSeatedPosition"	"Επαναφορά καθιστής θέσης"
"[english]PowerMenuResetSeatedPosition"	"Reset Seated Position"
"PowerMenuTurnOffController"	"Απενεργοποίηση χειριστηρίου"
"[english]PowerMenuTurnOffController"	"Turn Off Controller"
"PowerMenuQuitSceneApp"	"Έξοδος από το {s:current_app_name}"
"[english]PowerMenuQuitSceneApp"	"Exit {s:current_app_name}"
"PowerMenuExitVR"	"Έξοδος από το VR"
"[english]PowerMenuExitVR"	"Exit VR"
"PowerMenuCancel"	"Άκυρο"
"[english]PowerMenuCancel"	"Cancel"
"DashboardPower_Header"	"ΣΥΣΤΗΜΑ"
"[english]DashboardPower_Header"	"SYSTEM"
"UI_Paste_UnknownSource"	"[Επικόλληση]"
"[english]UI_Paste_UnknownSource"	"[Paste]"
"UI_Paste_CDKey"	"[Επικόλληση κλειδιού CD]"
"[english]UI_Paste_CDKey"	"[Paste CD Key]"
"UI_Paste_URL"	"[Επικόλληση URL]"
"[english]UI_Paste_URL"	"[Paste URL]"
"UI_Paste_Selection"	"[Επικόλληση]"
"[english]UI_Paste_Selection"	"[Paste]"
"ChaperoneHeader"	"Chaperone"
"[english]ChaperoneHeader"	"Chaperone"
"HeadsetHeader"	"Προσαρμογή"
"[english]HeadsetHeader"	"Customize"
"CameraHeader"	"Κάμερα"
"[english]CameraHeader"	"Camera"
"CollisionBoundStyle"	"Στυλ ορίων Chaperone"
"[english]CollisionBoundStyle"	"Chaperone bounds style"
"CollisionBoundBeginner"	"Για αρχάριους"
"[english]CollisionBoundBeginner"	"Beginner"
"CollisionBoundIntermediate"	"Για μέτριους"
"[english]CollisionBoundIntermediate"	"Intermediate"
"CollisionBoundSquares"	"Τετράγωνα"
"[english]CollisionBoundSquares"	"Squares"
"CollisionBoundAdvanced"	"Για προχωρημένους"
"[english]CollisionBoundAdvanced"	"Advanced"
"CollisionBoundDeveloper"	"Δημιουργός"
"[english]CollisionBoundDeveloper"	"Developer"
"BoundsColor"	"Χρώμα ορίων"
"[english]BoundsColor"	"Bounds Color"
"BoundsOpacity"	"Αδιαφάνεια ορίων"
"[english]BoundsOpacity"	"Bounds opacity"
"FloorBoundsAlwaysOn"	"Όρια δαπέδου πάντα ενεργά"
"[english]FloorBoundsAlwaysOn"	"Floor bounds always on"
"CollisionBoundsReset"	"Επαναφορά στις προεπιλογές"
"[english]CollisionBoundsReset"	"Reset to Default"
"GeneralVRSettingsHeader"	"Γενικές ρυθμίσεις VR"
"[english]GeneralVRSettingsHeader"	"General VR Settings"
"GoBack"	"Επιστροφή"
"[english]GoBack"	"Go Back"
"BackgroundColor"	"Χρώμα"
"[english]BackgroundColor"	"Color"
"BackgroundImage"	"Φόντο"
"[english]BackgroundImage"	"Background"
"BackgroundOpacity"	"Φωτεινότητα φόντου"
"[english]BackgroundOpacity"	"Background Brightness"
"BackgroundStyle"	"Στυλ φόντου"
"[english]BackgroundStyle"	"Background style"
"ExitToViewChanges"	" "
"[english]ExitToViewChanges"	" "
"SelectBackgroundImage"	"Επιλογή εικόνας φόντου"
"[english]SelectBackgroundImage"	"Select a background image"
"OpenImageFolderOnDesktop"	"Άνοιγμα φακέλου στην επιφάνεια εργασίας"
"[english]OpenImageFolderOnDesktop"	"Open Folder on Desktop"
"VRSettingsGeneral"	"Ρυθμίσεις SteamVR"
"[english]VRSettingsGeneral"	"SteamVR Settings"
"VRSettingsChaperone"	"Ρυθμίσεις Chaperone"
"[english]VRSettingsChaperone"	"Chaperone Settings"
"VRSettingsBackground"	"Προσαρμογή"
"[english]VRSettingsBackground"	"Customize"
"VRSettingsCamera"	"Ρυθμίσεις κάμερας"
"[english]VRSettingsCamera"	"Camera Settings"
"VRSettings_CameraInDashboard"	"Ενεργοποίηση κάμερας στην μπάρα"
"[english]VRSettings_CameraInDashboard"	"Enable Camera in Dashboard"
"VRSettings_CameraInChaperone"	"Χρήση κάμερας για τα όρια του Chaperone"
"[english]VRSettings_CameraInChaperone"	"Use Camera for Chaperone Bounds"
"VRSettings_CameraRoomView"	"Ενεργοποίηση προβολής δωματίου"
"[english]VRSettings_CameraRoomView"	"Enable Room View"
"VRSettingsCamera_RoomViewHelp"	"Πρόσβαση στην προβολή δωματίου με διπλό πάτημα του κουμπιού System"
"[english]VRSettingsCamera_RoomViewHelp"	"Access Room View by double pressing the System button"
"VRSettingsCamera_CameraColor"	"Χρώμα κάμερας Chaperone"
"[english]VRSettingsCamera_CameraColor"	"Camera Chaperone Color"
"VRSettingsCamera_CameraOpacity"	"Αδιαφάνεια κάμερας Chaperone"
"[english]VRSettingsCamera_CameraOpacity"	"Camera Chaperone Opacity"
"OpenBackgroundWorkshop"	"Περιήγηση στο Εργαστήρι"
"[english]OpenBackgroundWorkshop"	"Browse Workshop"
"VRSettingsCamera_EnableCamera"	"Για να ενεργοποιήσετε την εμπρόσθια κάμερα, ανατρέξτε στις ρυθμίσεις στην επιφάνεια εργασίας."
"[english]VRSettingsCamera_EnableCamera"	"To enable the front-facing camera go to Settings on the Desktop."
"VRSettingsCamera_EnableCameraAction"	"Άνοιγμα ρυθμίσεων στην επιφάνεια εργασίας"
"[english]VRSettingsCamera_EnableCameraAction"	"Open Settings on Desktop"
"BackgroundImageReload_Disabled"	"Ποτέ"
"[english]BackgroundImageReload_Disabled"	"Never"
"BackgroundImageReload_1hr"	"Μια φορά την ώρα"
"[english]BackgroundImageReload_1hr"	"Once an hour"
"BackgroundImageReload_1day"	"Μια φορά την ημέρα"
"[english]BackgroundImageReload_1day"	"Once a day"
"BackgroundImageReload_Help"	"Αλλαγή αυτόματα"
"[english]BackgroundImageReload_Help"	"Automatically change this"
"SelectModelSkin"	"Επιλέξτε ένα μοντέλο αντικατάστασης"
"[english]SelectModelSkin"	"Select a replacement model"
"ModelSkinName_Controller"	"Χειριστήριο"
"[english]ModelSkinName_Controller"	"Controller"
"ModelSKinName_BaseStation"	"Σταθμός βάσης"
"[english]ModelSKinName_BaseStation"	"Base Station"
"ModelSkinName_Camera"	"Κάμερα"
"[english]ModelSkinName_Camera"	"Camera"
"SkinHeader"	"Εμφανίσεις συσκευών"
"[english]SkinHeader"	"Device Skins"
"OpenSkinWorkshop"	"Εύρεση περισσότερων εμφανίσεων"
"[english]OpenSkinWorkshop"	"Find More Skins"
"ConfigurePlayArea"	"Διαμόρφωση περιοχής παιχνιδιού"
"[english]ConfigurePlayArea"	"Configure Play Area"
"PlayAreaButton"	"Περιοχή παιχνιδιού"
"[english]PlayAreaButton"	"Play Area"
"ModelSkinName_Stage"	"Περιβάλλον"
"[english]ModelSkinName_Stage"	"Environment"
"Screenshot_Progress_Description"	"Πρόοδος φωτογραφίας"
"[english]Screenshot_Progress_Description"	"Screenshot Progress"
"MimeHandlersHeader"	"Προεπιλεγμένα προγράμματα"
"[english]MimeHandlersHeader"	"Default Programs"
"VRSettingsMimeTypesTitle"	"Προεπιλεγμένα προγράμματα"
"[english]VRSettingsMimeTypesTitle"	"Default Programs"
"VRSettingsMimeTypes_GameTheater"	"Εκκίνηση παιχνιδιών χωρίς VR σε: "
"[english]VRSettingsMimeTypes_GameTheater"	"Launch Desktop Games in: "
"VRSettingsPowerTitle"	"Διαχείριση ενέργειας"
"[english]VRSettingsPowerTitle"	"Power Management"
"VRSettingsPower_TurnOffScreens"	"Απενεργοποίηση οθονών:"
"[english]VRSettingsPower_TurnOffScreens"	"Turn off displays:"
"VRSettingsPower_TurnOffControllers"	"Απενεργοποίηση χειριστηρίων:"
"[english]VRSettingsPower_TurnOffControllers"	"Turn off controllers:"
"SettingsTime_5s"	"μετά από 5 δευτερόλεπτα αδράνειας"
"[english]SettingsTime_5s"	"after 5 seconds of idle time"
"SettingsTime_30s"	"μετά από 30 δευτερόλεπτα αδράνειας"
"[english]SettingsTime_30s"	"after 30 seconds of idle time"
"SettingsTime_1m"	"μετά από 1 λεπτό αδράνειας"
"[english]SettingsTime_1m"	"after 1 minute of idle time"
"SettingsTime_5m"	"μετά από 5 λεπτά αδράνειας"
"[english]SettingsTime_5m"	"after 5 minutes of idle time"
"SettingsTime_10m"	"μετά από 10 λεπτά αδράνειας"
"[english]SettingsTime_10m"	"after 10 minutes of idle time"
"SettingsTime_20m"	"μετά από 20 λεπτά αδράνειας"
"[english]SettingsTime_20m"	"after 20 minutes of idle time"
"SettingsTime_Never"	"Ποτέ"
"[english]SettingsTime_Never"	"Never"
"VRSettingsPower_ExitSteamVR"	"Αυτόματη έξοδος από SteamVR:"
"[english]VRSettingsPower_ExitSteamVR"	"Automatically Exit SteamVR:"
"VRSettingsPower_ExitSteamVR_Description"	"Το SteamVR μπορεί να εκκινήσει με την ενεργοποίηση ενός χειριστηρίου, με το πάτημα του κουμπιού στο headset ή πατώντας το κουμπί VR στο Steam."
"[english]VRSettingsPower_ExitSteamVR_Description"	"SteamVR can be started by turning on a controller, pressing the button on the headset, or clicking the VR button in Steam."
"VRSettings_ResetToDefault"	"Επαναφορά προεπιλογών"
"[english]VRSettings_ResetToDefault"	"Reset to Default"
"TurnOffControllersWhenSteamVRExits"	"Απενεργοποίηση χειριστηρίων με την έξοδο από SteamVR"
"[english]TurnOffControllersWhenSteamVRExits"	"Turn off controllers when SteamVR exits"
"SettingsTime_30m"	"μετά από 30 λεπτά αδράνειας"
"[english]SettingsTime_30m"	"after 30 minutes of idle time"
"SettingsTime_1h"	"μετά από 1 ώρα αδράνειας"
"[english]SettingsTime_1h"	"after 1 hour of idle time"
"Now_Playing_HomeApp"	"ΣΠΙΤΙ"
"[english]Now_Playing_HomeApp"	"HOME"
"Now_Starting_HomeApp"	"ΜΕΤΑΒΑΣΗ ΣΕ"
"[english]Now_Starting_HomeApp"	"GOING HOME TO"
"VRSettingsMimeTypes_None"	"Χωρίς"
"[english]VRSettingsMimeTypes_None"	"None"
"VRSettingsMimeTypes_HomeApp"	"Οικιακή εφαρμογή: "
"[english]VRSettingsMimeTypes_HomeApp"	"Home App: "
"BackgroundImageSettings"	"Ρυθμίσεις"
"[english]BackgroundImageSettings"	"Settings"
"BackgroundImageReload_DomeProjection"	"Χρήση προβολής θόλου"
"[english]BackgroundImageReload_DomeProjection"	"Use Dome Projection"
"BackgroundImageReload_DomeRadius"	"Ακτίνα θόλου"
"[english]BackgroundImageReload_DomeRadius"	"Dome Radius"
"BackgroundImageReload_CameraHeight"	"Ύψος κάμερας"
"[english]BackgroundImageReload_CameraHeight"	"Camera Height"
"NightModeCheck"	"Λειτουργία νυκτός"
"[english]NightModeCheck"	"Night Mode"
"NightModeDesc"	"Η λειτουργία νυκτός χαμηλώνει τη φωτεινότητα του headset μέχρι τις 5:00 π.μ. (ή μέχρι να γίνει επανεκκίνηση του SteamVR)."
"[english]NightModeDesc"	"Night Mode dims the headset until 5:00 AM (or until SteamVR is restarted)."
"Transition_Progress_Description"	"ΑΝΑΜΟΝΗ ΓΙΑ..."
"[english]Transition_Progress_Description"	"WAITING FOR..."
"Now_Waiting"	"ΑΝΑΜΟΝΗ..."
"[english]Now_Waiting"	"WAITING..."
"HomeAppCheck"	"Ενισχυμένα μέρη SteamVR"
"[english]HomeAppCheck"	"Enhanced SteamVR Environments"
"HomeAppDesc"	"Τα νέα περιβάλλοντα SteamVR υποστηρίζουν πιο πλούσιους αρχικούς χώρους, κοινωνικές λειτουργίες και άλλα. Συμμετέχετε για να δοκιμάσετε και να δώσετε τις απόψεις σας στα forum του SteamVR."
"[english]HomeAppDesc"	"The new SteamVR Environments supports richer home spaces, social features, and more. Opt in to test and provide feedback on the SteamVR forums."
"MutedLabel"	"Σε σίγαση"
"[english]MutedLabel"	"Muted"
"BackToApp"	"ΠΙΣΩ ΣΕ ΕΦΑΡΜΟΓΗ"
"[english]BackToApp"	"BACK TO APP"
"GoHome"	"ΑΡΧΙΚΟΣ ΧΩΡΟΣ"
"[english]GoHome"	"GO HOME"
"QuitApp"	"ΕΞΟΔΟΣ"
"[english]QuitApp"	"QUIT APP"
"Customization_Disclaimer"	"Αν τα Ενισχυμένα μέρη SteamVR είναι ενεργά, χρησιμοποιήστε το μενού εντός εφαρμογής για να προσαρμόσετε τον αρχικό σας χώρο."
"[english]Customization_Disclaimer"	"If Enhanced SteamVR Environments is enabled, use the in-app menu to customize your home space."
"VRSettingsKnucklesTitle"	"Knuckles"
"[english]VRSettingsKnucklesTitle"	"Knuckles"
}
