"tenfoot"
{
"UI_Submit"	"Absenden"
"[english]UI_Submit"	"Submit"
"UI_Select"	"Auswählen"
"[english]UI_Select"	"Select"
"UI_Inspect"	"Untersuchen"
"[english]UI_Inspect"	"Inspect"
"UI_LeftStick_Short"	"LS"
"[english]UI_LeftStick_Short"	"LS"
"UI_RightStick_Short"	"RS"
"[english]UI_RightStick_Short"	"RS"
"UI_LeftTrigger_Short"	"LT"
"[english]UI_LeftTrigger_Short"	"LT"
"UI_RightTrigger_Short"	"RT"
"[english]UI_RightTrigger_Short"	"RT"
"UI_LeftBumper_Short"	"LB"
"[english]UI_LeftBumper_Short"	"LB"
"UI_RightBumper_Short"	"RB"
"[english]UI_RightBumper_Short"	"RB"
"UI_LeftBack_Short"	"LP"
"[english]UI_LeftBack_Short"	"LP"
"UI_RightBack_Short"	"RP"
"[english]UI_RightBack_Short"	"RP"
"UI_AButton"	"A"
"[english]UI_AButton"	"A"
"UI_BButton"	"B"
"[english]UI_BButton"	"B"
"UI_XButton"	"X"
"[english]UI_XButton"	"X"
"UI_YButton"	"Y"
"[english]UI_YButton"	"Y"
"UI_Cancel"	"ABBRECHEN"
"[english]UI_Cancel"	"CANCEL"
"UI_Dismiss"	"VERWERFEN"
"[english]UI_Dismiss"	"DISMISS"
"UI_Submit_Caps"	"ABSENDEN"
"[english]UI_Submit_Caps"	"SUBMIT"
"UI_OK"	"OK"
"[english]UI_OK"	"OK"
"UI_Done"	"FERTIG"
"[english]UI_Done"	"DONE"
"UI_Back"	"ZURÜCK"
"[english]UI_Back"	"BACK"
"UI_Yes"	"JA"
"[english]UI_Yes"	"YES"
"UI_No"	"NEIN"
"[english]UI_No"	"NO"
"UI_Unknown"	"UNBEKANNT"
"[english]UI_Unknown"	"UNKNOWN"
"UI_Always"	"IMMER"
"[english]UI_Always"	"ALWAYS"
"UI_Select_Footer"	"AUSWÄHLEN"
"[english]UI_Select_Footer"	"SELECT"
"UI_Cancel_Footer"	"ABBRECHEN"
"[english]UI_Cancel_Footer"	"CANCEL"
"UI_Back_Footer"	"ZURÜCK"
"[english]UI_Back_Footer"	"BACK"
"UI_Alert"	"Hinweis"
"[english]UI_Alert"	"Alert"
"UI_Backspace"	"RÜCKTASTE"
"[english]UI_Backspace"	"BACKSPACE"
"UI_Spacebar"	"LEERTASTE"
"[english]UI_Spacebar"	"SPACE"
"UI_MoveCaret"	"CURSOR BEWEGEN"
"[english]UI_MoveCaret"	"MOVE CURSOR"
"UI_MoveCaretLeft"	"« CURSOR"
"[english]UI_MoveCaretLeft"	"« CURSOR"
"UI_MoveCaretRight"	"CURSOR »"
"[english]UI_MoveCaretRight"	"CURSOR »"
"UI_InputDone"	"FERTIG"
"[english]UI_InputDone"	"DONE"
"UI_MoreOptions"	"WEITERE OPTIONEN"
"[english]UI_MoreOptions"	"MORE OPTIONS"
"UI_SendMessage"	"SENDEN"
"[english]UI_SendMessage"	"SEND"
"UI_Languages"	"SPRACHEN"
"[english]UI_Languages"	"LANGUAGES"
"UI_Next"	"WEITER"
"[english]UI_Next"	"NEXT"
"UI_Today"	"Heute"
"[english]UI_Today"	"Today"
"UI_Yesterday"	"Gestern"
"[english]UI_Yesterday"	"Yesterday"
"UI_Tomorrow"	"Morgen"
"[english]UI_Tomorrow"	"Tomorrow"
"UI_Hours"	"Stunden"
"[english]UI_Hours"	"hours"
"UI_Minutes"	"Minuten"
"[english]UI_Minutes"	"minutes"
"UI_Seconds"	"Sekunden"
"[english]UI_Seconds"	"seconds"
"UI_Hour"	"Stunde"
"[english]UI_Hour"	"hour"
"UI_Minute"	"Minute"
"[english]UI_Minute"	"minute"
"UI_Second"	"Sekunde"
"[english]UI_Second"	"second"
"UI_UnknownTime"	"Unbekannt"
"[english]UI_UnknownTime"	"Unknown"
"UI_Label_CopySelected"	"Ausgewählten Text kopieren"
"[english]UI_Label_CopySelected"	"Copy selected text"
"UI_Label_OpenLinkInBrowser"	"URL im Browser öffnen"
"[english]UI_Label_OpenLinkInBrowser"	"Open URL in browser"
"UI_Label_CopyURLToClipboard"	"URL in Zwischenablage kopieren"
"[english]UI_Label_CopyURLToClipboard"	"Copy URL to clipboard"
"UI_TextEntry_CutToClipboard"	"Ausschneiden"
"[english]UI_TextEntry_CutToClipboard"	"Cut"
"UI_TextEntry_CopyToClipboard"	"Kopieren"
"[english]UI_TextEntry_CopyToClipboard"	"Copy"
"UI_TextEntry_PasteClipboard"	"Einfügen"
"[english]UI_TextEntry_PasteClipboard"	"Paste"
"UI_Agreements"	"Vereinbarungen"
"[english]UI_Agreements"	"Agreements"
"UI_ViewAgreements"	"NUTZUNGSBEDINGUNGEN & DATENSCHUTZRICHTLINIEN ANZEIGEN"
"[english]UI_ViewAgreements"	"VIEW SSA & PRIVACY POLICY"
"UI_I_Agree"	"Ich stimme zu"
"[english]UI_I_Agree"	"I agree"
"Month_January"	"Januar"
"[english]Month_January"	"January"
"Month_February"	"Februar"
"[english]Month_February"	"February"
"Month_March"	"März"
"[english]Month_March"	"March"
"Month_April"	"April"
"[english]Month_April"	"April"
"Month_May"	"Mai"
"[english]Month_May"	"May"
"Month_June"	"Juni"
"[english]Month_June"	"June"
"Month_July"	"Juli"
"[english]Month_July"	"July"
"Month_August"	"August"
"[english]Month_August"	"August"
"Month_September"	"September"
"[english]Month_September"	"September"
"Month_October"	"Oktober"
"[english]Month_October"	"October"
"Month_November"	"November"
"[english]Month_November"	"November"
"Month_December"	"Dezember"
"[english]Month_December"	"December"
"UI_Continue"	"Weiter"
"[english]UI_Continue"	"Continue"
"UI_Age_Gate_Continue"	"WEITER"
"[english]UI_Age_Gate_Continue"	"CONTINUE"
"Panorama_Lang_English"	"Englisch"
"[english]Panorama_Lang_English"	"English"
"Panorama_Lang_Spanish"	"Spanisch"
"[english]Panorama_Lang_Spanish"	"Spanish"
"Panorama_Lang_French"	"Französisch"
"[english]Panorama_Lang_French"	"French"
"Panorama_Lang_Italian"	"Italienisch"
"[english]Panorama_Lang_Italian"	"Italian"
"Panorama_Lang_German"	"Deutsch"
"[english]Panorama_Lang_German"	"German"
"Panorama_Lang_Greek"	"Griechisch"
"[english]Panorama_Lang_Greek"	"Greek"
"Panorama_Lang_Korean"	"Koreanisch"
"[english]Panorama_Lang_Korean"	"Korean"
"Panorama_Lang_Simplified_Chinese"	"Vereinfachtes Chinesisch"
"[english]Panorama_Lang_Simplified_Chinese"	"Simplified Chinese"
"Panorama_Lang_Traditional_Chinese"	"Traditionelles Chinesisch"
"[english]Panorama_Lang_Traditional_Chinese"	"Traditional Chinese"
"Panorama_Lang_Russian"	"Russisch"
"[english]Panorama_Lang_Russian"	"Russian"
"Panorama_Lang_Thai"	"Thai"
"[english]Panorama_Lang_Thai"	"Thai"
"Panorama_Lang_Japanese"	"Japanisch"
"[english]Panorama_Lang_Japanese"	"Japanese"
"Panorama_Lang_Portuguese"	"Portugiesisch"
"[english]Panorama_Lang_Portuguese"	"Portuguese"
"Panorama_Lang_Brazilian"	"Brasilianisches Portugiesisch"
"[english]Panorama_Lang_Brazilian"	"Portuguese-Brazil"
"Panorama_Lang_Polish"	"Polnisch"
"[english]Panorama_Lang_Polish"	"Polish"
"Panorama_Lang_Danish"	"Dänisch"
"[english]Panorama_Lang_Danish"	"Danish"
"Panorama_Lang_Dutch"	"Niederländisch"
"[english]Panorama_Lang_Dutch"	"Dutch"
"Panorama_Lang_Finnish"	"Finnisch"
"[english]Panorama_Lang_Finnish"	"Finnish"
"Panorama_Lang_Norwegian"	"Norwegisch"
"[english]Panorama_Lang_Norwegian"	"Norwegian"
"Panorama_Lang_Swedish"	"Schwedisch"
"[english]Panorama_Lang_Swedish"	"Swedish"
"Panorama_Lang_Czech"	"Tschechisch"
"[english]Panorama_Lang_Czech"	"Czech"
"Panorama_Lang_Hungarian"	"Ungarisch"
"[english]Panorama_Lang_Hungarian"	"Hungarian"
"Panorama_Lang_Romanian"	"Rumänisch"
"[english]Panorama_Lang_Romanian"	"Romanian"
"Panorama_Lang_Bulgarian"	"Bulgarisch"
"[english]Panorama_Lang_Bulgarian"	"Bulgarian"
"Panorama_Lang_Turkish"	"Türkisch"
"[english]Panorama_Lang_Turkish"	"Turkish"
"Panorama_Lang_Arabic"	"Arabisch"
"[english]Panorama_Lang_Arabic"	"Arabic"
"Panorama_Lang_Ukrainian"	"Ukrainisch"
"[english]Panorama_Lang_Ukrainian"	"Ukrainian"
"Panorama_Lang_Footer_English"	"ENGLISCH"
"[english]Panorama_Lang_Footer_English"	"ENGLISH"
"Panorama_Lang_Footer_Spanish"	"SPANISCH"
"[english]Panorama_Lang_Footer_Spanish"	"SPANISH"
"Panorama_Lang_Footer_French"	"FRANZÖSISCH"
"[english]Panorama_Lang_Footer_French"	"FRENCH"
"Panorama_Lang_Footer_Italian"	"ITALIENISCH"
"[english]Panorama_Lang_Footer_Italian"	"ITALIAN"
"Panorama_Lang_Footer_German"	"DEUTSCH"
"[english]Panorama_Lang_Footer_German"	"GERMAN"
"Panorama_Lang_Footer_Greek"	"GRIECHISCH"
"[english]Panorama_Lang_Footer_Greek"	"GREEK"
"Panorama_Lang_Footer_Korean"	"KOREANISCH"
"[english]Panorama_Lang_Footer_Korean"	"KOREAN"
"Panorama_Lang_Footer_Simplified_Chinese"	"CHINESISCH (EINF.)"
"[english]Panorama_Lang_Footer_Simplified_Chinese"	"SIM CHINESE"
"Panorama_Lang_Footer_Traditional_Chinese"	"CHINESISCH (TRAD.)"
"[english]Panorama_Lang_Footer_Traditional_Chinese"	"TRAD CHINESE"
"Panorama_Lang_Footer_Russian"	"RUSSISCH"
"[english]Panorama_Lang_Footer_Russian"	"RUSSIAN"
"Panorama_Lang_Footer_Thai"	"THAI"
"[english]Panorama_Lang_Footer_Thai"	"THAI"
"Panorama_Lang_Footer_Japanese"	"JAPANISCH"
"[english]Panorama_Lang_Footer_Japanese"	"JAPANESE"
"Panorama_Lang_Footer_Portuguese"	"PORTUGIESISCH"
"[english]Panorama_Lang_Footer_Portuguese"	"PORTUGUESE"
"Panorama_Lang_Footer_Brazilian"	"B. PORTUGIESISCH"
"[english]Panorama_Lang_Footer_Brazilian"	"PORTUGUESE-B"
"Panorama_Lang_Footer_Polish"	"POLNISCH"
"[english]Panorama_Lang_Footer_Polish"	"POLISH"
"Panorama_Lang_Footer_Danish"	"DÄNISCH"
"[english]Panorama_Lang_Footer_Danish"	"DANISH"
"Panorama_Lang_Footer_Dutch"	"NIEDERLÄNDISCH"
"[english]Panorama_Lang_Footer_Dutch"	"DUTCH"
"Panorama_Lang_Footer_Finnish"	"FINNISCH"
"[english]Panorama_Lang_Footer_Finnish"	"FINNISH"
"Panorama_Lang_Footer_Norwegian"	"NORWEGISCH"
"[english]Panorama_Lang_Footer_Norwegian"	"NORWEGIAN"
"Panorama_Lang_Footer_Swedish"	"SCHWEDISCH"
"[english]Panorama_Lang_Footer_Swedish"	"SWEDISH"
"Panorama_Lang_Footer_Czech"	"TSCHECHISCH"
"[english]Panorama_Lang_Footer_Czech"	"CZECH"
"Panorama_Lang_Footer_Hungarian"	"UNGARISCH"
"[english]Panorama_Lang_Footer_Hungarian"	"HUNGARIAN"
"Panorama_Lang_Footer_Romanian"	"RUMÄNISCH"
"[english]Panorama_Lang_Footer_Romanian"	"ROMANIAN"
"Panorama_Lang_Footer_Bulgarian"	"BULGARISCH"
"[english]Panorama_Lang_Footer_Bulgarian"	"BULGARIAN"
"Panorama_Lang_Footer_Turkish"	"TÜRKISCH"
"[english]Panorama_Lang_Footer_Turkish"	"TURKISH"
"Panorama_Lang_Footer_Ukrainian"	"UKRAINISCH"
"[english]Panorama_Lang_Footer_Ukrainian"	"UKRAINIAN"
"Panorama_Selection_English"	"English (Englisch)"
"[english]Panorama_Selection_English"	"English"
"Panorama_Selection_Spanish"	"Español (Spanisch)"
"[english]Panorama_Selection_Spanish"	"Español (Spanish)"
"Panorama_Selection_French"	"Français (Französisch)"
"[english]Panorama_Selection_French"	"Français (French)"
"Panorama_Selection_Italian"	"Italiano (Italienisch)"
"[english]Panorama_Selection_Italian"	"Italiano (Italian)"
"Panorama_Selection_German"	"Deutsch (Deutsch)"
"[english]Panorama_Selection_German"	"Deutsch (German)"
"Panorama_Selection_Greek"	"Ελληνικά (Griechisch)"
"[english]Panorama_Selection_Greek"	"Ελληνικά (Greek)"
"Panorama_Selection_Korean"	"한국어 (Koreanisch)"
"[english]Panorama_Selection_Korean"	"한국어 (Korean)"
"Panorama_Selection_Simplified_Chinese"	"简体中文 (Vereinfachtes Chinesisch)"
"[english]Panorama_Selection_Simplified_Chinese"	"简体中文 (Simplified Chinese)"
"Panorama_Selection_Traditional_Chinese"	"繁體中文 (Traditionelles Chinesisch)"
"[english]Panorama_Selection_Traditional_Chinese"	"繁體中文 (Traditional Chinese)"
"Panorama_Selection_Russian"	"Русский (Russisch)"
"[english]Panorama_Selection_Russian"	"Русский (Russian)"
"Panorama_Selection_Thai"	"ไทย (Thai)"
"[english]Panorama_Selection_Thai"	"ไทย (Thai)"
"Panorama_Selection_Japanese"	"日本語 (Japanisch)"
"[english]Panorama_Selection_Japanese"	"日本語 (Japanese)"
"Panorama_Selection_Portuguese"	"Português (Portugiesisch)"
"[english]Panorama_Selection_Portuguese"	"Português (Portuguese)"
"Panorama_Selection_Brazilian"	"Português-Brasil (Brasil. Portugiesisch)"
"[english]Panorama_Selection_Brazilian"	"Português-Brasil (Portuguese-Brazil)"
"Panorama_Selection_Polish"	"Polski (Polnisch)"
"[english]Panorama_Selection_Polish"	"Polski (Polish)"
"Panorama_Selection_Danish"	"Dansk (Dänisch)"
"[english]Panorama_Selection_Danish"	"Dansk (Danish)"
"Panorama_Selection_Dutch"	"Nederlands (Niederländisch)"
"[english]Panorama_Selection_Dutch"	"Nederlands (Dutch)"
"Panorama_Selection_Finnish"	"Suomi (Finnisch)"
"[english]Panorama_Selection_Finnish"	"Suomi (Finnish)"
"Panorama_Selection_Norwegian"	"Norsk (Norwegisch)"
"[english]Panorama_Selection_Norwegian"	"Norsk (Norwegian)"
"Panorama_Selection_Swedish"	"Svenska (Schwedisch)"
"[english]Panorama_Selection_Swedish"	"Svenska (Swedish)"
"Panorama_Selection_Czech"	"Čeština (Tschechisch)"
"[english]Panorama_Selection_Czech"	"Čeština (Czech)"
"Panorama_Selection_Hungarian"	"Magyar (Ungarisch)"
"[english]Panorama_Selection_Hungarian"	"Magyar (Hungarian)"
"Panorama_Selection_Romanian"	"Română (Rumänisch)"
"[english]Panorama_Selection_Romanian"	"Română (Romanian)"
"Panorama_Selection_Bulgarian"	"Български (Bulgarisch)"
"[english]Panorama_Selection_Bulgarian"	"Български (Bulgarian)"
"Panorama_Selection_Turkish"	"Türkçe (Türkisch)"
"[english]Panorama_Selection_Turkish"	"Türkçe (Turkish)"
"Panorama_Selection_Arabic"	"العربية(Arabisch)"
"[english]Panorama_Selection_Arabic"	"العربية(Arabic)"
"Panorama_Selection_Ukrainian"	"Українська (Ukrainisch)"
"[english]Panorama_Selection_Ukrainian"	"Українська (Ukrainian)"
"Panorama_MoviePlaybackError"	"Während der Wiedergabe ist ein Fehler aufgetreten"
"[english]Panorama_MoviePlaybackError"	"An error ocurred during playback"
"Debugger_PaintInfo"	"Farbinformationen anzeigen"
"[english]Debugger_PaintInfo"	"Show Paint Info"
"Debugger_Style"	"Stil"
"[english]Debugger_Style"	"Style"
"Debugger_Computed"	"Berechnet"
"[english]Debugger_Computed"	"Computed"
"Debugger_Measurements"	"Messungen:"
"[english]Debugger_Measurements"	"Measurements:"
"Debugger_Misc"	"Versch.:"
"[english]Debugger_Misc"	"Misc:"
"Debugger_Properties"	"Eigenschaften:"
"[english]Debugger_Properties"	"Properties:"
"Debugger_StyleFileLink"	"{s:stylefile}"
"[english]Debugger_StyleFileLink"	"{s:stylefile}"
"Debugger_LayoutFileLink"	"{s:layoutfile}"
"[english]Debugger_LayoutFileLink"	"{s:layoutfile}"
"Debugger_LayoutFileLink_Code"	"Aus XML/Code"
"[english]Debugger_LayoutFileLink_Code"	"From XML/Code"
"Debugger_InheritedStyleHeader"	"vererbt von"
"[english]Debugger_InheritedStyleHeader"	"Inherited from "
"Debugger_Save"	"Alle Änderungen speichern"
"[english]Debugger_Save"	"Save All Changes"
"Debugger_Revert"	"Alle Änderungen rückgängig machen"
"[english]Debugger_Revert"	"Revert All Changes"
"Debugger_PanelStyleInvalid"	"Stile haben sich während der Bearbeitung geändert! Drücken Sie F5, um die angezeigten Stile neu zu laden"
"[english]Debugger_PanelStyleInvalid"	"Styles changed while editing! Hit F5 to reload displayed styles"
"Debugger_AnimationHeader"	"Animation Keyframes"
"[english]Debugger_AnimationHeader"	"Animation Keyframes"
"Debugger_DevInfo"	"Entwicklerinformationen anzeigen"
"[english]Debugger_DevInfo"	"Show Dev Info"
"Time"	"22:08"
"[english]Time"	"10:08"
"Time_Suffix"	""
"[english]Time_Suffix"	"PM"
"Now_Playing"	"WIRD GESPIELT"
"[english]Now_Playing"	"NOW PLAYING"
"Now_Quitting"	"WIRD BEENDET"
"[english]Now_Quitting"	"NOW EXITING"
"Quit"	"BEENDEN"
"[english]Quit"	"EXIT"
"App_Title"	"{s:current_app_name}"
"[english]App_Title"	"{s:current_app_name}"
"Menu_HTCVive"	"RE Vive"
"[english]Menu_HTCVive"	"RE Vive"
"Menu_HTCPhone"	"Smartphone"
"[english]Menu_HTCPhone"	"Phone"
"Menu_Steam"	"Steam"
"[english]Menu_Steam"	"Steam"
"Menu_Browser"	"Web"
"[english]Menu_Browser"	"Web"
"Menu_Friends"	"Freunde"
"[english]Menu_Friends"	"Friends"
"Notifications_Header"	"NEU"
"[english]Notifications_Header"	"NEW"
"VRHome_Header"	"ZURÜCK ZUM START"
"[english]VRHome_Header"	"RETURN TO HOME"
"Camera_Header"	"RAUMANSICHT"
"[english]Camera_Header"	"ROOM VIEW"
"Settings_Header"	"EINSTELLUNGEN"
"[english]Settings_Header"	"SETTINGS"
"Quit_Header"	"BEENDEN"
"[english]Quit_Header"	"QUIT"
"DashboardClose_Header"	"SCHLIESSEN"
"[english]DashboardClose_Header"	"CLOSE"
"Battery_Status"	"CONTROLLER"
"[english]Battery_Status"	"CONTROLLERS"
"Volume_Status"	"LAUTSTÄRKE"
"[english]Volume_Status"	"VOLUME"
"Gamepad_Tip"	"Im Dashboard navigieren"
"[english]Gamepad_Tip"	"Navigate Dashboard"
"Battery1_Status"	"Batterie 1"
"[english]Battery1_Status"	"Battery1"
"Battery2_Status"	"Batterie 2"
"[english]Battery2_Status"	"Battery2"
"VR_Status"	"VR-STATUS"
"[english]VR_Status"	"VR STATUS"
"VR_Notification_Title_Dashboard"	"Auf Dashboard zugreifen"
"[english]VR_Notification_Title_Dashboard"	"Access the Dashboard"
"VR_Notification_Content_Dashboard"	"Zum Anfangen Systemtaste drücken"
"[english]VR_Notification_Content_Dashboard"	"Press the System Button to begin"
"VRSettings"	"SteamVR-Einstellungen"
"[english]VRSettings"	"SteamVR Settings"
"NotificationsHeader"	"Benachrichtigungen"
"[english]NotificationsHeader"	"Notifications"
"NotificationsDesc"	"Wenn \"Nicht stören\" aktiviert ist, werden eingehende Benachrichtigungen unterdrückt."
"[english]NotificationsDesc"	"When Do Not Disturb is enabled, incoming notifications will be suppressed."
"NotificationsCheck"	"Nicht stören"
"[english]NotificationsCheck"	"Do Not Disturb"
"HomeHeader"	"Startanwendung"
"[english]HomeHeader"	"Startup Application"
"HomeDesc"	"Passen Sie Ihr Starterlebnis an."
"[english]HomeDesc"	"Customize your startup experience."
"CurrentHome"	"HomeApp"
"[english]CurrentHome"	"HomeApp"
"SetCurrentApp"	"Mit {s:current_app_name} starten"
"[english]SetCurrentApp"	"Startup with {s:current_app_name}"
"Microphone_Status"	"Mikrofon"
"[english]Microphone_Status"	"Microphone"
"OverlaysHeader"	"Dashboard-Overlays"
"[english]OverlaysHeader"	"Dashboard Overlays"
"OverlaysDesc"	"Overlays auswählen, die im Dashboard aktiv bleiben."
"[english]OverlaysDesc"	"Select Overlays to remain active in the Dashboard."
"OverlaysBrowse"	"Nach verfügbaren Overlays im Steam-Shop suchen"
"[english]OverlaysBrowse"	"Browse available Overlays in the Steam Store"
"Now_Starting"	"ALS NÄCHSTES"
"[english]Now_Starting"	"NEXT UP"
"Next_App_Name"	"{s:starting_app_name}"
"[english]Next_App_Name"	"{s:starting_app_name}"
"HomeAppNone"	"Leer"
"[english]HomeAppNone"	"None"
"HomeAppError"	"Fehler: Ungültige Anwendung"
"[english]HomeAppError"	"Error: Invalid App"
"IPD_Description"	"Distanz\nzwischen Linsen"
"[english]IPD_Description"	"Distance \nbetween lenses"
"IPD_Setting"	"{s:physical_ipd_mm}mm"
"[english]IPD_Setting"	"{s:physical_ipd_mm}mm"
"SeatedSetupHeader"	"Sitzposition vermessen"
"[english]SeatedSetupHeader"	"Seated Position Setup"
"SeatedSetupButton"	"Sitzposition zurücksetzen"
"[english]SeatedSetupButton"	"Reset Seated Position"
"SeatedSetupStatus"	"Um Ihre Sitzposition zurückzusetzen, setzen Sie sich in einer bequemen Position hin, schauen Sie nach vorne und klicken Sie auf die oben stehende Schaltfläche."
"[english]SeatedSetupStatus"	"To reset your seated position, face forward in a relaxed sitting position and press the button above."
"PromptCancelQuestion"	"Sind Sie sicher, dass Sie {s:current_app_name} beenden möchten?"
"[english]PromptCancelQuestion"	"Are you sure you want to exit {s:current_app_name}?"
"PromptCancelInfo"	"Nicht gespeicherte Fortschritte gehen verloren."
"[english]PromptCancelInfo"	"You may lose progress if you haven't saved."
"PromptCancelTransition"	"Abbrechen"
"[english]PromptCancelTransition"	"Cancel"
"PromptQuitAnyway"	"Trotzdem beenden"
"[english]PromptQuitAnyway"	"Exit Anyway"
"PowerMenuViewRoom"	"Raumansicht umschalten"
"[english]PowerMenuViewRoom"	"Toggle Room View"
"PowerMenuResetSeatedPosition"	"Sitzposition zurücksetzen"
"[english]PowerMenuResetSeatedPosition"	"Reset Seated Position"
"PowerMenuTurnOffController"	"Controller ausschalten"
"[english]PowerMenuTurnOffController"	"Turn Off Controller"
"PowerMenuQuitSceneApp"	"{s:current_app_name} beenden"
"[english]PowerMenuQuitSceneApp"	"Exit {s:current_app_name}"
"PowerMenuExitVR"	"VR beenden"
"[english]PowerMenuExitVR"	"Exit VR"
"PowerMenuCancel"	"Abbrechen"
"[english]PowerMenuCancel"	"Cancel"
"DashboardPower_Header"	"SYSTEM"
"[english]DashboardPower_Header"	"SYSTEM"
"UI_Paste_UnknownSource"	"[Einfügen]"
"[english]UI_Paste_UnknownSource"	"[Paste]"
"UI_Paste_CDKey"	"[Produktschlüssel einfügen]"
"[english]UI_Paste_CDKey"	"[Paste CD Key]"
"UI_Paste_URL"	"[URL einfügen]"
"[english]UI_Paste_URL"	"[Paste URL]"
"UI_Paste_Selection"	"[Einfügen]"
"[english]UI_Paste_Selection"	"[Paste]"
"ChaperoneHeader"	"Chaperone"
"[english]ChaperoneHeader"	"Chaperone"
"HeadsetHeader"	"Anpassen"
"[english]HeadsetHeader"	"Customize"
"CameraHeader"	"Kamera"
"[english]CameraHeader"	"Camera"
"CollisionBoundStyle"	"Stil der Begrenzungslinien"
"[english]CollisionBoundStyle"	"Chaperone bounds style"
"CollisionBoundBeginner"	"Anfänger"
"[english]CollisionBoundBeginner"	"Beginner"
"CollisionBoundIntermediate"	"Fortgeschritten"
"[english]CollisionBoundIntermediate"	"Intermediate"
"CollisionBoundSquares"	"Quadrate"
"[english]CollisionBoundSquares"	"Squares"
"CollisionBoundAdvanced"	"Linien"
"[english]CollisionBoundAdvanced"	"Advanced"
"CollisionBoundDeveloper"	"Entwickler"
"[english]CollisionBoundDeveloper"	"Developer"
"BoundsColor"	"Abgrenzungsfarbe"
"[english]BoundsColor"	"Bounds Color"
"BoundsOpacity"	"Abgrenzungsdeckkraft"
"[english]BoundsOpacity"	"Bounds opacity"
"FloorBoundsAlwaysOn"	"Bodengrenze immer an"
"[english]FloorBoundsAlwaysOn"	"Floor bounds always on"
"CollisionBoundsReset"	"Standard wiederherstellen"
"[english]CollisionBoundsReset"	"Reset to Default"
"GeneralVRSettingsHeader"	"Allgemeine VR-Einstellungen"
"[english]GeneralVRSettingsHeader"	"General VR Settings"
"GoBack"	"Zurück"
"[english]GoBack"	"Go Back"
"BackgroundColor"	"Farbe"
"[english]BackgroundColor"	"Color"
"BackgroundImage"	"Hintergrund"
"[english]BackgroundImage"	"Background"
"BackgroundOpacity"	"Helligkeit des Hintergrunds"
"[english]BackgroundOpacity"	"Background Brightness"
"BackgroundStyle"	"Hintergrundstil"
"[english]BackgroundStyle"	"Background style"
"ExitToViewChanges"	"

"
"[english]ExitToViewChanges"	" "
"SelectBackgroundImage"	"Hintergrundbild auswählen"
"[english]SelectBackgroundImage"	"Select a background image"
"OpenImageFolderOnDesktop"	"Verzeichnis im Explorer öffnen"
"[english]OpenImageFolderOnDesktop"	"Open Folder on Desktop"
"VRSettingsGeneral"	"SteamVR-Einstellungen"
"[english]VRSettingsGeneral"	"SteamVR Settings"
"VRSettingsChaperone"	"Chaperone-Einstellungen"
"[english]VRSettingsChaperone"	"Chaperone Settings"
"VRSettingsBackground"	"Anpassen"
"[english]VRSettingsBackground"	"Customize"
"VRSettingsCamera"	"Kameraeinstellungen"
"[english]VRSettingsCamera"	"Camera Settings"
"VRSettings_CameraInDashboard"	"Kamera im Dashboard aktivieren"
"[english]VRSettings_CameraInDashboard"	"Enable Camera in Dashboard"
"VRSettings_CameraInChaperone"	"Kamera für Chaperone-Grenzen nutzen"
"[english]VRSettings_CameraInChaperone"	"Use Camera for Chaperone Bounds"
"VRSettings_CameraRoomView"	"Raumansicht aktivieren"
"[english]VRSettings_CameraRoomView"	"Enable Room View"
"VRSettingsCamera_RoomViewHelp"	"Raumansicht durch doppeltes Drücken der Systemtaste aktivieren"
"[english]VRSettingsCamera_RoomViewHelp"	"Access Room View by double pressing the System button"
"VRSettingsCamera_CameraColor"	"Chaperone-Farbe"
"[english]VRSettingsCamera_CameraColor"	"Camera Chaperone Color"
"VRSettingsCamera_CameraOpacity"	"Chaperone-Durchsichtigkeit"
"[english]VRSettingsCamera_CameraOpacity"	"Camera Chaperone Opacity"
"OpenBackgroundWorkshop"	"Workshop durchsuchen"
"[english]OpenBackgroundWorkshop"	"Browse Workshop"
"VRSettingsCamera_EnableCamera"	"Um die Frontkamera zu aktivieren, rufen Sie die Einstellungen über den Desktop auf."
"[english]VRSettingsCamera_EnableCamera"	"To enable the front-facing camera go to Settings on the Desktop."
"VRSettingsCamera_EnableCameraAction"	"Einstellungen auf dem Desktop öffnen"
"[english]VRSettingsCamera_EnableCameraAction"	"Open Settings on Desktop"
"BackgroundImageReload_Disabled"	"Niemals"
"[english]BackgroundImageReload_Disabled"	"Never"
"BackgroundImageReload_1hr"	"Einmal pro Stunde"
"[english]BackgroundImageReload_1hr"	"Once an hour"
"BackgroundImageReload_1day"	"Einmal pro Tag"
"[english]BackgroundImageReload_1day"	"Once a day"
"BackgroundImageReload_Help"	"Automatisch wechseln"
"[english]BackgroundImageReload_Help"	"Automatically change this"
"SelectModelSkin"	"Ein Ersatzmodell auswählen"
"[english]SelectModelSkin"	"Select a replacement model"
"ModelSkinName_Controller"	"Controller"
"[english]ModelSkinName_Controller"	"Controller"
"ModelSKinName_BaseStation"	"Basisstation"
"[english]ModelSKinName_BaseStation"	"Base Station"
"ModelSkinName_Camera"	"Kamera"
"[english]ModelSkinName_Camera"	"Camera"
"SkinHeader"	"Geräte-Skins"
"[english]SkinHeader"	"Device Skins"
"OpenSkinWorkshop"	"Weitere Skins"
"[english]OpenSkinWorkshop"	"Find More Skins"
"ConfigurePlayArea"	"Spielbereich konfigurieren"
"[english]ConfigurePlayArea"	"Configure Play Area"
"PlayAreaButton"	"Spielbereich"
"[english]PlayAreaButton"	"Play Area"
"ModelSkinName_Stage"	"Umgebung"
"[english]ModelSkinName_Stage"	"Environment"
"Screenshot_Progress_Description"	"Screenshot-Fortschritt"
"[english]Screenshot_Progress_Description"	"Screenshot Progress"
"MimeHandlersHeader"	"Standardprogramme"
"[english]MimeHandlersHeader"	"Default Programs"
"VRSettingsMimeTypesTitle"	"Standardprogramme"
"[english]VRSettingsMimeTypesTitle"	"Default Programs"
"VRSettingsMimeTypes_GameTheater"	"Desktopspiele starten in: "
"[english]VRSettingsMimeTypes_GameTheater"	"Launch Desktop Games in: "
"VRSettingsPowerTitle"	"Energieverwaltung"
"[english]VRSettingsPowerTitle"	"Power Management"
"VRSettingsPower_TurnOffScreens"	"Bildschirme ausschalten:"
"[english]VRSettingsPower_TurnOffScreens"	"Turn off displays:"
"VRSettingsPower_TurnOffControllers"	"Controller ausschalten:"
"[english]VRSettingsPower_TurnOffControllers"	"Turn off controllers:"
"SettingsTime_5s"	"nach 5 Sekunden Inaktivität"
"[english]SettingsTime_5s"	"after 5 seconds of idle time"
"SettingsTime_30s"	"nach 30 Sekunden Inaktivität"
"[english]SettingsTime_30s"	"after 30 seconds of idle time"
"SettingsTime_1m"	"nach 1 Minute Inaktivität"
"[english]SettingsTime_1m"	"after 1 minute of idle time"
"SettingsTime_5m"	"nach 5 Minuten Inaktivität"
"[english]SettingsTime_5m"	"after 5 minutes of idle time"
"SettingsTime_10m"	"nach 10 Minuten Inaktivität"
"[english]SettingsTime_10m"	"after 10 minutes of idle time"
"SettingsTime_20m"	"nach 20 Minuten Inaktivität"
"[english]SettingsTime_20m"	"after 20 minutes of idle time"
"SettingsTime_Never"	"Nie"
"[english]SettingsTime_Never"	"Never"
"VRSettingsPower_ExitSteamVR"	"SteamVR automatisch beenden:"
"[english]VRSettingsPower_ExitSteamVR"	"Automatically Exit SteamVR:"
"VRSettingsPower_ExitSteamVR_Description"	"Sie können SteamVR starten, indem Sie einen Controller einschalten, die Taste auf dem VR-Headset drücken oder auf die VR-Schaltfläche in Steam klicken."
"[english]VRSettingsPower_ExitSteamVR_Description"	"SteamVR can be started by turning on a controller, pressing the button on the headset, or clicking the VR button in Steam."
"VRSettings_ResetToDefault"	"Auf Standard zurücksetzen"
"[english]VRSettings_ResetToDefault"	"Reset to Default"
"TurnOffControllersWhenSteamVRExits"	"Controller beim Beenden von SteamVR ausschalten"
"[english]TurnOffControllersWhenSteamVRExits"	"Turn off controllers when SteamVR exits"
"SettingsTime_30m"	"nach 30 Minuten Inaktivität"
"[english]SettingsTime_30m"	"after 30 minutes of idle time"
"SettingsTime_1h"	"nach 1 Stunde Inaktivität"
"[english]SettingsTime_1h"	"after 1 hour of idle time"
"Now_Playing_HomeApp"	"HOME"
"[english]Now_Playing_HomeApp"	"HOME"
"Now_Starting_HomeApp"	"ZUR HOME-ANWENDUNG"
"[english]Now_Starting_HomeApp"	"GOING HOME TO"
"VRSettingsMimeTypes_None"	"Nichts"
"[english]VRSettingsMimeTypes_None"	"None"
"VRSettingsMimeTypes_HomeApp"	"Home-Anwendung: "
"[english]VRSettingsMimeTypes_HomeApp"	"Home App: "
"BackgroundImageSettings"	"Einstellungen"
"[english]BackgroundImageSettings"	"Settings"
"BackgroundImageReload_DomeProjection"	"Kuppelprojektion verwenden"
"[english]BackgroundImageReload_DomeProjection"	"Use Dome Projection"
"BackgroundImageReload_DomeRadius"	"Kuppelradius"
"[english]BackgroundImageReload_DomeRadius"	"Dome Radius"
"BackgroundImageReload_CameraHeight"	"Kamerahöhe"
"[english]BackgroundImageReload_CameraHeight"	"Camera Height"
"NightModeCheck"	"Nachtmodus"
"[english]NightModeCheck"	"Night Mode"
"NightModeDesc"	"Im Nachtmodus wird das VR-Headset bis 5 Uhr abgedunkelt (oder bis SteamVR neu gestartet wird)."
"[english]NightModeDesc"	"Night Mode dims the headset until 5:00 AM (or until SteamVR is restarted)."
"Transition_Progress_Description"	"WARTE AUF..."
"[english]Transition_Progress_Description"	"WAITING FOR..."
"Now_Waiting"	"WARTEN..."
"[english]Now_Waiting"	"WAITING..."
"HomeAppCheck"	"Erweiterte SteamVR-Umgebungen"
"[english]HomeAppCheck"	"SteamVR Home"
"HomeAppDesc"	"Die neuen SteamVR-Umgebungen unterstützen reichhaltigere Startorte, soziale Funktionen und mehr. Melden Sie sich an, um sie zu testen und geben Sie uns in den SteamVR-Foren Feedback."
"[english]HomeAppDesc"	"SteamVR Home experience supports richer home spaces, social features, and more."
"MutedLabel"	"Stumm"
"[english]MutedLabel"	"Muted"
"BackToApp"	"ZURÜCK ZUR ANWENDUNG"
"[english]BackToApp"	"BACK TO APP"
"GoHome"	"ZUR STARTSEITE"
"[english]GoHome"	"GO HOME"
"QuitApp"	"ANWENDUNG BEENDEN"
"[english]QuitApp"	"QUIT APP"
"Customization_Disclaimer"	"Wenn die Einstellung \"Erweiterte SteamVR-Umgebungen\" aktiviert ist, nutzen Sie bitte das Menü in der App, um Ihre Startumgebung anzupassen."
"[english]Customization_Disclaimer"	"If Enhanced SteamVR Environments is enabled, use the in-app menu to customize your home space."
"VRSettingsKnucklesTitle"	"Knuckles"
"[english]VRSettingsKnucklesTitle"	"Knuckles"
"VRSettingsKnuckles_CapsenseMode"	"Kapazitive-Sensoren-Modus"
"[english]VRSettingsKnuckles_CapsenseMode"	"Cap Sense Mode"
"KnucklesCapsenseMode_0"	"Fingererfassung (Standard)"
"[english]KnucklesCapsenseMode_0"	"Finger Tracking (Default)"
"KnucklesCapsenseMode_1"	"Fingererfassung deaktiviert"
"[english]KnucklesCapsenseMode_1"	"Finger Tracking Disabled"
"KnucklesCapsenseMode_2"	"Kapazitive Sensoren als Trigger"
"[english]KnucklesCapsenseMode_2"	"Cap Sense controls Trigger"
"KnucklesCapsenseMode_3"	"Kapazitive Sensoren zum Greifen"
"[english]KnucklesCapsenseMode_3"	"Cap Sense controls Grip"
"VRSettingsCamera_RoomViewMode_Label"	"Kameramodus für Raumansicht"
"[english]VRSettingsCamera_RoomViewMode_Label"	"Room View Camera Mode"
"VRSettingsCamera_RoomViewMode_EdgeA"	"Farbige Konturen"
"[english]VRSettingsCamera_RoomViewMode_EdgeA"	"Colored Edges"
"VRSettingsCamera_RoomViewMode_EdgeB"	"Farbige Geister"
"[english]VRSettingsCamera_RoomViewMode_EdgeB"	"Colored Ghosts"
"VRSettingsCamera_RoomViewMode_VideoTransluscent"	"Durchsichtiger Passthrough"
"[english]VRSettingsCamera_RoomViewMode_VideoTransluscent"	"Translucent Pass-Through"
"VRSettingsCamera_RoomViewMode_VideoOpaque"	"Undurchsichtiger Passthrough"
"[english]VRSettingsCamera_RoomViewMode_VideoOpaque"	"Opaque Pass-Through"
"VRSettingsBindingUITitle"	"Controllerbelegung"
"[english]VRSettingsBindingUITitle"	"Controller Binding"
"VRSettingsTrackerUITitle"	"Vive-Tracker verwalten"
"[english]VRSettingsTrackerUITitle"	"Manage Vive Trackers"
"BindingCallout_Header"	"STEUERUNG ANZEIGEN"
"[english]BindingCallout_Header"	"SHOW CONTROLS"
}
