"tenfoot"
{
"UI_Submit"	"Gönder"
"[english]UI_Submit"	"Submit"
"UI_Select"	"Seç"
"[english]UI_Select"	"Select"
"UI_Inspect"	"İncele"
"[english]UI_Inspect"	"Inspect"
"UI_LeftStick_Short"	"LS"
"[english]UI_LeftStick_Short"	"LS"
"UI_RightStick_Short"	"RS"
"[english]UI_RightStick_Short"	"RS"
"UI_LeftTrigger_Short"	"LT"
"[english]UI_LeftTrigger_Short"	"LT"
"UI_RightTrigger_Short"	"RT"
"[english]UI_RightTrigger_Short"	"RT"
"UI_LeftBumper_Short"	"LB"
"[english]UI_LeftBumper_Short"	"LB"
"UI_RightBumper_Short"	"RB"
"[english]UI_RightBumper_Short"	"RB"
"UI_LeftBack_Short"	"LP"
"[english]UI_LeftBack_Short"	"LP"
"UI_RightBack_Short"	"RP"
"[english]UI_RightBack_Short"	"RP"
"UI_AButton"	"A"
"[english]UI_AButton"	"A"
"UI_BButton"	"B"
"[english]UI_BButton"	"B"
"UI_XButton"	"X"
"[english]UI_XButton"	"X"
"UI_YButton"	"Y"
"[english]UI_YButton"	"Y"
"UI_Cancel"	"İPTAL"
"[english]UI_Cancel"	"CANCEL"
"UI_Dismiss"	"İPTAL"
"[english]UI_Dismiss"	"DISMISS"
"UI_Submit_Caps"	"GÖNDER"
"[english]UI_Submit_Caps"	"SUBMIT"
"UI_OK"	"TAMAM"
"[english]UI_OK"	"OK"
"UI_Done"	"TAMAM"
"[english]UI_Done"	"DONE"
"UI_Back"	"GERİ"
"[english]UI_Back"	"BACK"
"UI_Yes"	"EVET"
"[english]UI_Yes"	"YES"
"UI_No"	"HAYIR"
"[english]UI_No"	"NO"
"UI_Unknown"	"Bilinmiyor"
"[english]UI_Unknown"	"UNKNOWN"
"UI_Always"	"DAİMA"
"[english]UI_Always"	"ALWAYS"
"UI_Select_Footer"	"SEÇ"
"[english]UI_Select_Footer"	"SELECT"
"UI_Cancel_Footer"	"İptal"
"[english]UI_Cancel_Footer"	"CANCEL"
"UI_Back_Footer"	"BACK"
"[english]UI_Back_Footer"	"BACK"
"UI_Alert"	"Uyarı"
"[english]UI_Alert"	"Alert"
"UI_Backspace"	"BACKSPACE"
"[english]UI_Backspace"	"BACKSPACE"
"UI_Spacebar"	"BOŞLUK"
"[english]UI_Spacebar"	"SPACE"
"UI_MoveCaret"	"İMLECİ KULLAN"
"[english]UI_MoveCaret"	"MOVE CURSOR"
"UI_MoveCaretLeft"	"« İMLEÇ"
"[english]UI_MoveCaretLeft"	"« CURSOR"
"UI_MoveCaretRight"	"İMLEÇ »"
"[english]UI_MoveCaretRight"	"CURSOR »"
"UI_InputDone"	"TAMAM"
"[english]UI_InputDone"	"DONE"
"UI_MoreOptions"	"DAHA FAZLA SEÇENEK"
"[english]UI_MoreOptions"	"MORE OPTIONS"
"UI_SendMessage"	"GÖNDER"
"[english]UI_SendMessage"	"SEND"
"UI_Languages"	"DİLLER"
"[english]UI_Languages"	"LANGUAGES"
"UI_Next"	"SONRAKİ"
"[english]UI_Next"	"NEXT"
"UI_Today"	"Bugün"
"[english]UI_Today"	"Today"
"UI_Yesterday"	"Dün"
"[english]UI_Yesterday"	"Yesterday"
"UI_Tomorrow"	"Yarın"
"[english]UI_Tomorrow"	"Tomorrow"
"UI_Hours"	"saat"
"[english]UI_Hours"	"hours"
"UI_Minutes"	"dakika"
"[english]UI_Minutes"	"minutes"
"UI_Seconds"	"saniye"
"[english]UI_Seconds"	"seconds"
"UI_Hour"	"saat"
"[english]UI_Hour"	"hour"
"UI_Minute"	"dakika"
"[english]UI_Minute"	"minute"
"UI_Second"	"saniye"
"[english]UI_Second"	"second"
"UI_UnknownTime"	"Bilinmiyor"
"[english]UI_UnknownTime"	"Unknown"
"UI_Label_CopySelected"	"Metni kopyala"
"[english]UI_Label_CopySelected"	"Copy selected text"
"UI_Label_OpenLinkInBrowser"	"Bağlantıyı tarayıcıda aç"
"[english]UI_Label_OpenLinkInBrowser"	"Open URL in browser"
"UI_Label_CopyURLToClipboard"	"Adresi panoya kopyala"
"[english]UI_Label_CopyURLToClipboard"	"Copy URL to clipboard"
"UI_TextEntry_CutToClipboard"	"Kes"
"[english]UI_TextEntry_CutToClipboard"	"Cut"
"UI_TextEntry_CopyToClipboard"	"Kopyala"
"[english]UI_TextEntry_CopyToClipboard"	"Copy"
"UI_TextEntry_PasteClipboard"	"Yapıştır"
"[english]UI_TextEntry_PasteClipboard"	"Paste"
"UI_Agreements"	"Kurallar"
"[english]UI_Agreements"	"Agreements"
"UI_ViewAgreements"	"SAS & GİZLİLİK POLİTİKASINI GÖRÜNTÜLE"
"[english]UI_ViewAgreements"	"VIEW SSA & PRIVACY POLICY"
"UI_I_Agree"	"KABUL EDİYORUM"
"[english]UI_I_Agree"	"I agree"
"Month_January"	"Ocak"
"[english]Month_January"	"January"
"Month_February"	"Şubat"
"[english]Month_February"	"February"
"Month_March"	"Mart"
"[english]Month_March"	"March"
"Month_April"	"Nisan"
"[english]Month_April"	"April"
"Month_May"	"Mayıs"
"[english]Month_May"	"May"
"Month_June"	"Haziran"
"[english]Month_June"	"June"
"Month_July"	"Temmuz"
"[english]Month_July"	"July"
"Month_August"	"Ağustos"
"[english]Month_August"	"August"
"Month_September"	"Eylül"
"[english]Month_September"	"September"
"Month_October"	"Ekim"
"[english]Month_October"	"October"
"Month_November"	"Kasım"
"[english]Month_November"	"November"
"Month_December"	"Aralık"
"[english]Month_December"	"December"
"UI_Continue"	"Devam"
"[english]UI_Continue"	"Continue"
"UI_Age_Gate_Continue"	"Devam"
"[english]UI_Age_Gate_Continue"	"CONTINUE"
"Panorama_Lang_English"	"İngilizce"
"[english]Panorama_Lang_English"	"English"
"Panorama_Lang_Spanish"	"İSPANYOLCA"
"[english]Panorama_Lang_Spanish"	"Spanish"
"Panorama_Lang_French"	"FRANSIZCA"
"[english]Panorama_Lang_French"	"French"
"Panorama_Lang_Italian"	"İTALYANCA"
"[english]Panorama_Lang_Italian"	"Italian"
"Panorama_Lang_German"	"ALMANCA"
"[english]Panorama_Lang_German"	"German"
"Panorama_Lang_Greek"	"YUNANCA"
"[english]Panorama_Lang_Greek"	"Greek"
"Panorama_Lang_Korean"	"KORECE"
"[english]Panorama_Lang_Korean"	"Korean"
"Panorama_Lang_Simplified_Chinese"	"Basitleştirilmiş Çince"
"[english]Panorama_Lang_Simplified_Chinese"	"Simplified Chinese"
"Panorama_Lang_Traditional_Chinese"	"Geleneksel Çince"
"[english]Panorama_Lang_Traditional_Chinese"	"Traditional Chinese"
"Panorama_Lang_Russian"	"RUSÇA"
"[english]Panorama_Lang_Russian"	"Russian"
"Panorama_Lang_Thai"	"TAYCA"
"[english]Panorama_Lang_Thai"	"Thai"
"Panorama_Lang_Japanese"	"JAPONCA"
"[english]Panorama_Lang_Japanese"	"Japanese"
"Panorama_Lang_Portuguese"	"PORTEKİZCE"
"[english]Panorama_Lang_Portuguese"	"Portuguese"
"Panorama_Lang_Brazilian"	"Brezilya Portekizcesi"
"[english]Panorama_Lang_Brazilian"	"Portuguese-Brazil"
"Panorama_Lang_Polish"	"LEHÇE"
"[english]Panorama_Lang_Polish"	"Polish"
"Panorama_Lang_Danish"	"Danca"
"[english]Panorama_Lang_Danish"	"Danish"
"Panorama_Lang_Dutch"	"Felemenkçe"
"[english]Panorama_Lang_Dutch"	"Dutch"
"Panorama_Lang_Finnish"	"Fince"
"[english]Panorama_Lang_Finnish"	"Finnish"
"Panorama_Lang_Norwegian"	"NORVEÇÇE"
"[english]Panorama_Lang_Norwegian"	"Norwegian"
"Panorama_Lang_Swedish"	"İSVEÇÇE"
"[english]Panorama_Lang_Swedish"	"Swedish"
"Panorama_Lang_Czech"	"Çekçe"
"[english]Panorama_Lang_Czech"	"Czech"
"Panorama_Lang_Hungarian"	"MACARCA"
"[english]Panorama_Lang_Hungarian"	"Hungarian"
"Panorama_Lang_Romanian"	"RUMENCE"
"[english]Panorama_Lang_Romanian"	"Romanian"
"Panorama_Lang_Bulgarian"	"Bulgarca"
"[english]Panorama_Lang_Bulgarian"	"Bulgarian"
"Panorama_Lang_Turkish"	"TÜRKÇE"
"[english]Panorama_Lang_Turkish"	"Turkish"
"Panorama_Lang_Arabic"	"Arapça"
"[english]Panorama_Lang_Arabic"	"Arabic"
"Panorama_Lang_Ukrainian"	"UKRAYNACA"
"[english]Panorama_Lang_Ukrainian"	"Ukrainian"
"Panorama_Lang_Footer_English"	"İngilizce"
"[english]Panorama_Lang_Footer_English"	"ENGLISH"
"Panorama_Lang_Footer_Spanish"	"İSPANYOLCA"
"[english]Panorama_Lang_Footer_Spanish"	"SPANISH"
"Panorama_Lang_Footer_French"	"FRANSIZCA"
"[english]Panorama_Lang_Footer_French"	"FRENCH"
"Panorama_Lang_Footer_Italian"	"İTALYANCA"
"[english]Panorama_Lang_Footer_Italian"	"ITALIAN"
"Panorama_Lang_Footer_German"	"ALMANCA"
"[english]Panorama_Lang_Footer_German"	"GERMAN"
"Panorama_Lang_Footer_Greek"	"YUNANCA"
"[english]Panorama_Lang_Footer_Greek"	"GREEK"
"Panorama_Lang_Footer_Korean"	"KORECE"
"[english]Panorama_Lang_Footer_Korean"	"KOREAN"
"Panorama_Lang_Footer_Simplified_Chinese"	"BASİT. ÇİNCE"
"[english]Panorama_Lang_Footer_Simplified_Chinese"	"SIM CHINESE"
"Panorama_Lang_Footer_Traditional_Chinese"	"GELEN. ÇİNCE"
"[english]Panorama_Lang_Footer_Traditional_Chinese"	"TRAD CHINESE"
"Panorama_Lang_Footer_Russian"	"RUSÇA"
"[english]Panorama_Lang_Footer_Russian"	"RUSSIAN"
"Panorama_Lang_Footer_Thai"	"TAYCA"
"[english]Panorama_Lang_Footer_Thai"	"THAI"
"Panorama_Lang_Footer_Japanese"	"JAPONCA"
"[english]Panorama_Lang_Footer_Japanese"	"JAPANESE"
"Panorama_Lang_Footer_Portuguese"	"PORTEKİZCE"
"[english]Panorama_Lang_Footer_Portuguese"	"PORTUGUESE"
"Panorama_Lang_Footer_Brazilian"	"BRE. PORTEKİZCESİ"
"[english]Panorama_Lang_Footer_Brazilian"	"PORTUGUESE-B"
"Panorama_Lang_Footer_Polish"	"LEHÇE"
"[english]Panorama_Lang_Footer_Polish"	"POLISH"
"Panorama_Lang_Footer_Danish"	"Danca"
"[english]Panorama_Lang_Footer_Danish"	"DANISH"
"Panorama_Lang_Footer_Dutch"	"Felemenkçe"
"[english]Panorama_Lang_Footer_Dutch"	"DUTCH"
"Panorama_Lang_Footer_Finnish"	"Fince"
"[english]Panorama_Lang_Footer_Finnish"	"FINNISH"
"Panorama_Lang_Footer_Norwegian"	"NORVEÇÇE"
"[english]Panorama_Lang_Footer_Norwegian"	"NORWEGIAN"
"Panorama_Lang_Footer_Swedish"	"İSVEÇÇE"
"[english]Panorama_Lang_Footer_Swedish"	"SWEDISH"
"Panorama_Lang_Footer_Czech"	"Çekçe"
"[english]Panorama_Lang_Footer_Czech"	"CZECH"
"Panorama_Lang_Footer_Hungarian"	"MACARCA"
"[english]Panorama_Lang_Footer_Hungarian"	"HUNGARIAN"
"Panorama_Lang_Footer_Romanian"	"RUMENCE"
"[english]Panorama_Lang_Footer_Romanian"	"ROMANIAN"
"Panorama_Lang_Footer_Bulgarian"	"Bulgarca"
"[english]Panorama_Lang_Footer_Bulgarian"	"BULGARIAN"
"Panorama_Lang_Footer_Turkish"	"TÜRKÇE"
"[english]Panorama_Lang_Footer_Turkish"	"TURKISH"
"Panorama_Lang_Footer_Ukrainian"	"UKRAYNACA"
"[english]Panorama_Lang_Footer_Ukrainian"	"UKRAINIAN"
"Panorama_Selection_English"	"İngilizce"
"[english]Panorama_Selection_English"	"English"
"Panorama_Selection_Spanish"	"Español (İspanyolca)"
"[english]Panorama_Selection_Spanish"	"Español (Spanish)"
"Panorama_Selection_French"	"Français (Fransızca)"
"[english]Panorama_Selection_French"	"Français (French)"
"Panorama_Selection_Italian"	"Italiano (İtalyanca)"
"[english]Panorama_Selection_Italian"	"Italiano (Italian)"
"Panorama_Selection_German"	"Deutsch (Almanca)"
"[english]Panorama_Selection_German"	"Deutsch (German)"
"Panorama_Selection_Greek"	"Ελληνικά (Yunanca)"
"[english]Panorama_Selection_Greek"	"Ελληνικά (Greek)"
"Panorama_Selection_Korean"	"한국어 (Korece)"
"[english]Panorama_Selection_Korean"	"한국어 (Korean)"
"Panorama_Selection_Simplified_Chinese"	"简体中文 (Basit Çince)"
"[english]Panorama_Selection_Simplified_Chinese"	"简体中文 (Simplified Chinese)"
"Panorama_Selection_Traditional_Chinese"	"繁體中文 (Geleneksel Çince)"
"[english]Panorama_Selection_Traditional_Chinese"	"繁體中文 (Traditional Chinese)"
"Panorama_Selection_Russian"	"Русский (Rusça)"
"[english]Panorama_Selection_Russian"	"Русский (Russian)"
"Panorama_Selection_Thai"	"ไทย (Tayca)"
"[english]Panorama_Selection_Thai"	"ไทย (Thai)"
"Panorama_Selection_Japanese"	"日本語 (Japonca)"
"[english]Panorama_Selection_Japanese"	"日本語 (Japanese)"
"Panorama_Selection_Portuguese"	"Português (Portekizce)"
"[english]Panorama_Selection_Portuguese"	"Português (Portuguese)"
"Panorama_Selection_Brazilian"	"Português-Brasil (Brezilya Portekizcesi)"
"[english]Panorama_Selection_Brazilian"	"Português-Brasil (Portuguese-Brazil)"
"Panorama_Selection_Polish"	"Polski (Lehçe)"
"[english]Panorama_Selection_Polish"	"Polski (Polish)"
"Panorama_Selection_Danish"	"Dansk (Danca)"
"[english]Panorama_Selection_Danish"	"Dansk (Danish)"
"Panorama_Selection_Dutch"	"Nederlands (Felemenkçe)"
"[english]Panorama_Selection_Dutch"	"Nederlands (Dutch)"
"Panorama_Selection_Finnish"	"Finnish (Fince)"
"[english]Panorama_Selection_Finnish"	"Suomi (Finnish)"
"Panorama_Selection_Norwegian"	"Norsk (Norveççe)"
"[english]Panorama_Selection_Norwegian"	"Norsk (Norwegian)"
"Panorama_Selection_Swedish"	"Svenska (İsveççe)"
"[english]Panorama_Selection_Swedish"	"Svenska (Swedish)"
"Panorama_Selection_Czech"	"čeština (Çekçe)"
"[english]Panorama_Selection_Czech"	"čeština (Czech)"
"Panorama_Selection_Hungarian"	"Magyar (Macarca)"
"[english]Panorama_Selection_Hungarian"	"Magyar (Hungarian)"
"Panorama_Selection_Romanian"	"Română (Rumence)"
"[english]Panorama_Selection_Romanian"	"Română (Romanian)"
"Panorama_Selection_Bulgarian"	"Български (Bulgarca)"
"[english]Panorama_Selection_Bulgarian"	"Български (Bulgarian)"
"Panorama_Selection_Turkish"	"Türkçe"
"[english]Panorama_Selection_Turkish"	"Türkçe (Turkish)"
"Panorama_Selection_Arabic"	"العربية (Arapça)"
"[english]Panorama_Selection_Arabic"	"العربية(Arabic)"
"Panorama_Selection_Ukrainian"	"Українська (Ukraynaca)"
"[english]Panorama_Selection_Ukrainian"	"Українська (Ukrainian)"
"Panorama_MoviePlaybackError"	"Çalma sırasında bir hata meydana geldi"
"[english]Panorama_MoviePlaybackError"	"An error ocurred during playback"
"Debugger_PaintInfo"	"Boya Bilgisini Göster"
"[english]Debugger_PaintInfo"	"Show Paint Info"
"Debugger_Style"	"Tarz"
"[english]Debugger_Style"	"Style"
"Debugger_Computed"	"Hesaplanmış"
"[english]Debugger_Computed"	"Computed"
"Debugger_Measurements"	"Ölçüler:"
"[english]Debugger_Measurements"	"Measurements:"
"Debugger_Misc"	"Çeşitli:"
"[english]Debugger_Misc"	"Misc:"
"Debugger_Properties"	"Özellikler:"
"[english]Debugger_Properties"	"Properties:"
"Debugger_StyleFileLink"	"{s:stylefile}"
"[english]Debugger_StyleFileLink"	"{s:stylefile}"
"Debugger_LayoutFileLink"	"{s:layoutfile}"
"[english]Debugger_LayoutFileLink"	"{s:layoutfile}"
"Debugger_LayoutFileLink_Code"	"XML\\'den/Koddan"
"[english]Debugger_LayoutFileLink_Code"	"From XML/Code"
"Debugger_InheritedStyleHeader"	"Miras alındığı"
"[english]Debugger_InheritedStyleHeader"	"Inherited from "
"Debugger_Save"	"Tüm Değişiklikleri Kaydet"
"[english]Debugger_Save"	"Save All Changes"
"Debugger_Revert"	"Tüm Değişiklikleri Geri Al"
"[english]Debugger_Revert"	"Revert All Changes"
"Debugger_PanelStyleInvalid"	"Düzenleme yapılırken stil değiştirildi! Stili tekrar yüklemek için F5 tuşuna basın."
"[english]Debugger_PanelStyleInvalid"	"Styles changed while editing! Hit F5 to reload displayed styles"
"Debugger_AnimationHeader"	"Animasyon Anahtar Kareleri"
"[english]Debugger_AnimationHeader"	"Animation Keyframes"
"Debugger_DevInfo"	"Geliştirici Bilgisi"
"[english]Debugger_DevInfo"	"Show Dev Info"
"Time"	"10:08"
"[english]Time"	"10:08"
"Time_Suffix"	"ÖS"
"[english]Time_Suffix"	"PM"
"Now_Playing"	"Şimdi çalıyor"
"[english]Now_Playing"	"NOW PLAYING"
"Now_Quitting"	"ŞİMDİ ÇIKILIYOR"
"[english]Now_Quitting"	"NOW EXITING"
"Quit"	"ÇIKIŞ"
"[english]Quit"	"EXIT"
"App_Title"	"{s:current_app_name}"
"[english]App_Title"	"{s:current_app_name}"
"Menu_HTCVive"	"RE Vive"
"[english]Menu_HTCVive"	"RE Vive"
"Menu_HTCPhone"	"Telefon"
"[english]Menu_HTCPhone"	"Phone"
"Menu_Steam"	"STEAM"
"[english]Menu_Steam"	"Steam"
"Menu_Browser"	"İnternet"
"[english]Menu_Browser"	"Web"
"Menu_Friends"	"Arkadaşlar"
"[english]Menu_Friends"	"Friends"
"Notifications_Header"	"YENİ"
"[english]Notifications_Header"	"NEW"
"VRHome_Header"	"ANA SAYFAYA DÖN"
"[english]VRHome_Header"	"RETURN TO HOME"
"Camera_Header"	"ODA GÖRÜNÜŞÜ"
"[english]Camera_Header"	"ROOM VIEW"
"Settings_Header"	"AYARLAR"
"[english]Settings_Header"	"SETTINGS"
"Quit_Header"	"ÇIKIŞ"
"[english]Quit_Header"	"QUIT"
"DashboardClose_Header"	"KAPAT"
"[english]DashboardClose_Header"	"CLOSE"
"Battery_Status"	"KONTROLLER"
"[english]Battery_Status"	"CONTROLLERS"
"Volume_Status"	"Ses"
"[english]Volume_Status"	"VOLUME"
"Gamepad_Tip"	"Panoda Gezin"
"[english]Gamepad_Tip"	"Navigate Dashboard"
"Battery1_Status"	"Batarya1"
"[english]Battery1_Status"	"Battery1"
"Battery2_Status"	"Batarya2"
"[english]Battery2_Status"	"Battery2"
"VR_Status"	"VR DURUMU"
"[english]VR_Status"	"VR STATUS"
"VR_Notification_Title_Dashboard"	"Panoya Eriş"
"[english]VR_Notification_Title_Dashboard"	"Access the Dashboard"
"VR_Notification_Content_Dashboard"	"Başlamak için Sistem Düğmesine basın"
"[english]VR_Notification_Content_Dashboard"	"Press the System Button to begin"
"VRSettings"	"SteamVR Ayarları"
"[english]VRSettings"	"SteamVR Settings"
"NotificationsHeader"	"Bildirimler"
"[english]NotificationsHeader"	"Notifications"
"NotificationsDesc"	"Rahatsız Etme etkin olduğunda gelen bildirimler gösterilmez."
"[english]NotificationsDesc"	"When Do Not Disturb is enabled, incoming notifications will be suppressed."
"NotificationsCheck"	"Rahatsız Etme"
"[english]NotificationsCheck"	"Do Not Disturb"
"HomeHeader"	"Başlangıç Uygulaması"
"[english]HomeHeader"	"Startup Application"
"HomeDesc"	"Başlangıç deneyiminizi özelleştirin."
"[english]HomeDesc"	"Customize your startup experience."
"CurrentHome"	"Ana Sayfa Uygulaması"
"[english]CurrentHome"	"HomeApp"
"SetCurrentApp"	"{s:current_app_name} ile başla"
"[english]SetCurrentApp"	"Startup with {s:current_app_name}"
"Microphone_Status"	"Mikrofon"
"[english]Microphone_Status"	"Microphone"
"OverlaysHeader"	"Pano Arayüzleri"
"[english]OverlaysHeader"	"Dashboard Overlays"
"OverlaysDesc"	"Pano'da etkin kalacak olan Arayüzleri seç"
"[english]OverlaysDesc"	"Select Overlays to remain active in the Dashboard."
"OverlaysBrowse"	"Steam Mağazası'ndaki mevcut Arayüzlere göz at"
"[english]OverlaysBrowse"	"Browse available Overlays in the Steam Store"
"Now_Starting"	"SONRAKİ"
"[english]Now_Starting"	"NEXT UP"
"Next_App_Name"	"{s:starting_app_name}"
"[english]Next_App_Name"	"{s:starting_app_name}"
"HomeAppNone"	"Yok"
"[english]HomeAppNone"	"None"
"HomeAppError"	"Hata: Geçersiz Uygulama"
"[english]HomeAppError"	"Error: Invalid App"
"IPD_Description"	"Lensler \narası mesafe"
"[english]IPD_Description"	"Distance \nbetween lenses"
"IPD_Setting"	"{s:physical_ipd_mm}mm"
"[english]IPD_Setting"	"{s:physical_ipd_mm}mm"
"SeatedSetupHeader"	"Oturma Pozisyonu Ayarla"
"[english]SeatedSetupHeader"	"Seated Position Setup"
"SeatedSetupButton"	"Oturma Pozisyonunu Sıfırla"
"[english]SeatedSetupButton"	"Reset Seated Position"
"SeatedSetupStatus"	"Sabit pozisyonu yeniden ayarlamak için rahatlamış bir biçimde oturarak ileriye doğru bakın ve yukarıdaki butona basın."
"[english]SeatedSetupStatus"	"To reset your seated position, face forward in a relaxed sitting position and press the button above."
"PromptCancelQuestion"	"{s:current_app_name} uygulamasından çıkış yapmak istediğinize emin misiniz?"
"[english]PromptCancelQuestion"	"Are you sure you want to exit {s:current_app_name}?"
"PromptCancelInfo"	"Eğer kaydetmediyseniz ilerlemenizi kaybedebilirsiniz."
"[english]PromptCancelInfo"	"You may lose progress if you haven't saved."
"PromptCancelTransition"	"İptal"
"[english]PromptCancelTransition"	"Cancel"
"PromptQuitAnyway"	"Yine de çık"
"[english]PromptQuitAnyway"	"Exit Anyway"
"PowerMenuViewRoom"	"Oda Görünüşünü Aç/Kapat"
"[english]PowerMenuViewRoom"	"Toggle Room View"
"PowerMenuResetSeatedPosition"	"Oturma Pozisyonunu Sıfırla"
"[english]PowerMenuResetSeatedPosition"	"Reset Seated Position"
"PowerMenuTurnOffController"	"Oyun Kumandasını Kapat"
"[english]PowerMenuTurnOffController"	"Turn Off Controller"
"PowerMenuQuitSceneApp"	"{s:current_app_name} uygulamasından çık"
"[english]PowerMenuQuitSceneApp"	"Exit {s:current_app_name}"
"PowerMenuExitVR"	"VR'dan Çık"
"[english]PowerMenuExitVR"	"Exit VR"
"PowerMenuCancel"	"İptal"
"[english]PowerMenuCancel"	"Cancel"
"DashboardPower_Header"	"SİSTEM"
"[english]DashboardPower_Header"	"SYSTEM"
"UI_Paste_UnknownSource"	"[Yapıştır]"
"[english]UI_Paste_UnknownSource"	"[Paste]"
"UI_Paste_CDKey"	"[CD Anahtarını Yapıştır]"
"[english]UI_Paste_CDKey"	"[Paste CD Key]"
"UI_Paste_URL"	"[URL'yi Yapıştır]"
"[english]UI_Paste_URL"	"[Paste URL]"
"UI_Paste_Selection"	"[Yapıştır]"
"[english]UI_Paste_Selection"	"[Paste]"
"ChaperoneHeader"	"Chaperone"
"[english]ChaperoneHeader"	"Chaperone"
"HeadsetHeader"	"Özelleştir"
"[english]HeadsetHeader"	"Customize"
"CameraHeader"	"Kamera"
"[english]CameraHeader"	"Camera"
"CollisionBoundStyle"	"Chaperone sınırları stili"
"[english]CollisionBoundStyle"	"Chaperone bounds style"
"CollisionBoundBeginner"	"Acemi"
"[english]CollisionBoundBeginner"	"Beginner"
"CollisionBoundIntermediate"	"Orta Düzey"
"[english]CollisionBoundIntermediate"	"Intermediate"
"CollisionBoundSquares"	"Kareler"
"[english]CollisionBoundSquares"	"Squares"
"CollisionBoundAdvanced"	"Gelişmiş"
"[english]CollisionBoundAdvanced"	"Advanced"
"CollisionBoundDeveloper"	"Geliştirici"
"[english]CollisionBoundDeveloper"	"Developer"
"BoundsColor"	"Sınırların Rengi"
"[english]BoundsColor"	"Bounds Color"
"BoundsOpacity"	"Sınırların Saydamlığı"
"[english]BoundsOpacity"	"Bounds opacity"
"FloorBoundsAlwaysOn"	"Zemin sınırları her zaman açık"
"[english]FloorBoundsAlwaysOn"	"Floor bounds always on"
"CollisionBoundsReset"	"Varsayılana Sıfırla"
"[english]CollisionBoundsReset"	"Reset to Default"
"GeneralVRSettingsHeader"	"Genel VR Ayarları"
"[english]GeneralVRSettingsHeader"	"General VR Settings"
"GoBack"	"Geri Git"
"[english]GoBack"	"Go Back"
"BackgroundColor"	"Renk"
"[english]BackgroundColor"	"Color"
"BackgroundImage"	"Arka Plan"
"[english]BackgroundImage"	"Background"
"BackgroundOpacity"	"Arka Plan Parlaklığı"
"[english]BackgroundOpacity"	"Background Brightness"
"BackgroundStyle"	"Arka Plan stili"
"[english]BackgroundStyle"	"Background style"
"ExitToViewChanges"	" "
"[english]ExitToViewChanges"	" "
"SelectBackgroundImage"	"Bir arka plan resmi seçin"
"[english]SelectBackgroundImage"	"Select a background image"
"OpenImageFolderOnDesktop"	"Masaüstünde Klasör Açın"
"[english]OpenImageFolderOnDesktop"	"Open Folder on Desktop"
"VRSettingsGeneral"	"SteamVR Ayarları"
"[english]VRSettingsGeneral"	"SteamVR Settings"
"VRSettingsChaperone"	"Chaperone Ayarları"
"[english]VRSettingsChaperone"	"Chaperone Settings"
"VRSettingsBackground"	"Özelleştir"
"[english]VRSettingsBackground"	"Customize"
"VRSettingsCamera"	"Kamera Ayarları"
"[english]VRSettingsCamera"	"Camera Settings"
"VRSettings_CameraInDashboard"	"Kamerayı Gösterge Panelinde Etkinleştir"
"[english]VRSettings_CameraInDashboard"	"Enable Camera in Dashboard"
"VRSettings_CameraInChaperone"	"Chaperone Sınırları için Kamerayı kullan"
"[english]VRSettings_CameraInChaperone"	"Use Camera for Chaperone Bounds"
"VRSettings_CameraRoomView"	"Oda Görünüşünü Etkinleştir"
"[english]VRSettings_CameraRoomView"	"Enable Room View"
"VRSettingsCamera_RoomViewHelp"	"Sistem butonuna iki kez basarak Oda Görünüşüne erişin"
"[english]VRSettingsCamera_RoomViewHelp"	"Access Room View by double pressing the System button"
"VRSettingsCamera_CameraColor"	"Chaperone Kamerası Rengi"
"[english]VRSettingsCamera_CameraColor"	"Camera Chaperone Color"
"VRSettingsCamera_CameraOpacity"	"Chaperone Kamerası Saydamlığı"
"[english]VRSettingsCamera_CameraOpacity"	"Camera Chaperone Opacity"
"OpenBackgroundWorkshop"	"Atölye'ye Göz At"
"[english]OpenBackgroundWorkshop"	"Browse Workshop"
"VRSettingsCamera_EnableCamera"	"Ön taraftaki kamerayı etkinleştirmek için Masaüstünden Ayarlara gidin"
"[english]VRSettingsCamera_EnableCamera"	"To enable the front-facing camera go to Settings on the Desktop."
"VRSettingsCamera_EnableCameraAction"	"Ayarları Masaüstünde aç"
"[english]VRSettingsCamera_EnableCameraAction"	"Open Settings on Desktop"
"BackgroundImageReload_Disabled"	"Hiçbir Zaman"
"[english]BackgroundImageReload_Disabled"	"Never"
"BackgroundImageReload_1hr"	"Saatte bir kez"
"[english]BackgroundImageReload_1hr"	"Once an hour"
"BackgroundImageReload_1day"	"Günde bir kez"
"[english]BackgroundImageReload_1day"	"Once a day"
"BackgroundImageReload_Help"	"Bunu otomatik olarak değiştir"
"[english]BackgroundImageReload_Help"	"Automatically change this"
"SelectModelSkin"	"Yerine yerleştirilecek bir model seçin"
"[english]SelectModelSkin"	"Select a replacement model"
"ModelSkinName_Controller"	"Kontrolcü"
"[english]ModelSkinName_Controller"	"Controller"
"ModelSKinName_BaseStation"	"Ana İstasyon"
"[english]ModelSKinName_BaseStation"	"Base Station"
"ModelSkinName_Camera"	"Kamera"
"[english]ModelSkinName_Camera"	"Camera"
"SkinHeader"	"Aygıt Kaplmaları"
"[english]SkinHeader"	"Device Skins"
"OpenSkinWorkshop"	"Daha Fazla Kaplama Bul"
"[english]OpenSkinWorkshop"	"Find More Skins"
"ConfigurePlayArea"	"Oyun Alanını Ayarlayın"
"[english]ConfigurePlayArea"	"Configure Play Area"
"PlayAreaButton"	"Oyun Alanı"
"[english]PlayAreaButton"	"Play Area"
"ModelSkinName_Stage"	"Çevre"
"[english]ModelSkinName_Stage"	"Environment"
"Screenshot_Progress_Description"	"Ekran Görüntüsü İlerlemesi"
"[english]Screenshot_Progress_Description"	"Screenshot Progress"
"MimeHandlersHeader"	"Varsayılan Programlar"
"[english]MimeHandlersHeader"	"Default Programs"
"VRSettingsMimeTypesTitle"	"Varsayılan Programlar"
"[english]VRSettingsMimeTypesTitle"	"Default Programs"
"VRSettingsMimeTypes_GameTheater"	"Masaüstü Oyunlarını şunda başlat: "
"[english]VRSettingsMimeTypes_GameTheater"	"Launch Desktop Games in: "
"VRSettingsPowerTitle"	"Güç Yönetimi"
"[english]VRSettingsPowerTitle"	"Power Management"
"VRSettingsPower_TurnOffScreens"	"Ekranları kapat:"
"[english]VRSettingsPower_TurnOffScreens"	"Turn off displays:"
"VRSettingsPower_TurnOffControllers"	"Kontrolcüleri kapat"
"[english]VRSettingsPower_TurnOffControllers"	"Turn off controllers:"
"SettingsTime_5s"	"5 saniye boşta bekledikten sonra"
"[english]SettingsTime_5s"	"after 5 seconds of idle time"
"SettingsTime_30s"	"30 saniye boşta bekledikten sonra"
"[english]SettingsTime_30s"	"after 30 seconds of idle time"
"SettingsTime_1m"	"1 dakika boşta bekledikten sonra"
"[english]SettingsTime_1m"	"after 1 minute of idle time"
"SettingsTime_5m"	"5 dakika boşta bekledikten sonra"
"[english]SettingsTime_5m"	"after 5 minutes of idle time"
"SettingsTime_10m"	"10 dakika boşta bekledikten sonra"
"[english]SettingsTime_10m"	"after 10 minutes of idle time"
"SettingsTime_20m"	"20 dakika boşta bekledikten sonra"
"[english]SettingsTime_20m"	"after 20 minutes of idle time"
"SettingsTime_Never"	"Asla"
"[english]SettingsTime_Never"	"Never"
"VRSettingsPower_ExitSteamVR"	"SteamVR'ı otomatik olarak kapat:"
"[english]VRSettingsPower_ExitSteamVR"	"Automatically Exit SteamVR:"
"VRSettingsPower_ExitSteamVR_Description"	"SteamVR bir kontrolcü çalıştırıldığında, başlık üzerindeki tuşa basıldığında veya Steam'de VR butonuna tıklandığında başlatılabilir."
"[english]VRSettingsPower_ExitSteamVR_Description"	"SteamVR can be started by turning on a controller, pressing the button on the headset, or clicking the VR button in Steam."
"VRSettings_ResetToDefault"	"Varsayılana Sıfırla"
"[english]VRSettings_ResetToDefault"	"Reset to Default"
"TurnOffControllersWhenSteamVRExits"	"SteamVR'dan çıkıldığında kontrolcüleri kapat"
"[english]TurnOffControllersWhenSteamVRExits"	"Turn off controllers when SteamVR exits"
"SettingsTime_30m"	"30 dakika boşta bekledikten sonra"
"[english]SettingsTime_30m"	"after 30 minutes of idle time"
"SettingsTime_1h"	"1 saat boşta bekledikten sonra"
"[english]SettingsTime_1h"	"after 1 hour of idle time"
"Now_Playing_HomeApp"	"EV"
"[english]Now_Playing_HomeApp"	"HOME"
"Now_Starting_HomeApp"	"ŞU EVE GİDİLİYOR:"
"[english]Now_Starting_HomeApp"	"GOING HOME TO"
"VRSettingsMimeTypes_None"	"Hiçbiri"
"[english]VRSettingsMimeTypes_None"	"None"
"VRSettingsMimeTypes_HomeApp"	"Başlangıç Uygulaması: "
"[english]VRSettingsMimeTypes_HomeApp"	"Home App: "
"BackgroundImageSettings"	"Ayarlar"
"[english]BackgroundImageSettings"	"Settings"
"BackgroundImageReload_DomeProjection"	"Dome Tuşu Gösterimini Kullan"
"[english]BackgroundImageReload_DomeProjection"	"Use Dome Projection"
"BackgroundImageReload_DomeRadius"	"Kubbe Yarıçapı"
"[english]BackgroundImageReload_DomeRadius"	"Dome Radius"
"BackgroundImageReload_CameraHeight"	"Kamera Yüksekliği"
"[english]BackgroundImageReload_CameraHeight"	"Camera Height"
"NightModeCheck"	"Gece Modu"
"[english]NightModeCheck"	"Night Mode"
"NightModeDesc"	"Gece Modu başlığın ışığının parlaklığını 05:00'a kadar kısar (veya SteamVR yeniden başlatılana kadar)."
"[english]NightModeDesc"	"Night Mode dims the headset until 5:00 AM (or until SteamVR is restarted)."
"Transition_Progress_Description"	"BEKLENİYOR..."
"[english]Transition_Progress_Description"	"WAITING FOR..."
"Now_Waiting"	"BEKLENİYOR..."
"[english]Now_Waiting"	"WAITING..."
"HomeAppCheck"	"Gelişmiş SteamVR Ortamları"
"[english]HomeAppCheck"	"Enhanced SteamVR Environments"
"HomeAppDesc"	"Yeni SteamVR Ortamları daha çeşitli evler, sosyal özellikler ve daha fazlasını destekler. SteamVR forumlarında geri bildirim vermek için ve test edebilmek için siz de katılın."
"[english]HomeAppDesc"	"The new SteamVR Environments supports richer home spaces, social features, and more. Opt in to test and provide feedback on the SteamVR forums."
"MutedLabel"	"Susturuldu"
"[english]MutedLabel"	"Muted"
"BackToApp"	"UYGULAMAYA GERİ DÖN"
"[english]BackToApp"	"BACK TO APP"
"GoHome"	"EVE DÖN"
"[english]GoHome"	"GO HOME"
"QuitApp"	"UYGULAMADAN ÇIK"
"[english]QuitApp"	"QUIT APP"
"Customization_Disclaimer"	"Gelişmiş SteamVR Ortamları etkinleştirilmişse, ev alanınızı özelleştirmek için uygulama içi menüyü kullanın."
"[english]Customization_Disclaimer"	"If Enhanced SteamVR Environments is enabled, use the in-app menu to customize your home space."
"VRSettingsKnucklesTitle"	"Knuckles"
"[english]VRSettingsKnucklesTitle"	"Knuckles"
"VRSettingsKnuckles_CapsenseMode"	"Kapasitif Algılama Modu"
"[english]VRSettingsKnuckles_CapsenseMode"	"Cap Sense Mode"
"KnucklesCapsenseMode_0"	"Parmak İzleme (Varsayılan)"
"[english]KnucklesCapsenseMode_0"	"Finger Tracking (Default)"
"KnucklesCapsenseMode_1"	"Parmak İzleme Devre Dışı"
"[english]KnucklesCapsenseMode_1"	"Finger Tracking Disabled"
"KnucklesCapsenseMode_2"	"Tetik - Kapasitif Algılama Modu"
"[english]KnucklesCapsenseMode_2"	"Cap Sense controls Trigger"
"KnucklesCapsenseMode_3"	"Kavrama - Kapasitif Algılama Modu"
"[english]KnucklesCapsenseMode_3"	"Cap Sense controls Grip"
"VRSettingsCamera_RoomViewMode_Label"	"Oda Görüşü Kamera Modu"
"[english]VRSettingsCamera_RoomViewMode_Label"	"Room View Camera Mode"
"VRSettingsCamera_RoomViewMode_EdgeA"	"Renkli Kenarlar"
"[english]VRSettingsCamera_RoomViewMode_EdgeA"	"Colored Edges"
"VRSettingsCamera_RoomViewMode_EdgeB"	"Renkli Hayaletler"
"[english]VRSettingsCamera_RoomViewMode_EdgeB"	"Colored Ghosts"
"VRSettingsCamera_RoomViewMode_VideoTransluscent"	"Yarısaydam Görünüm"
"[english]VRSettingsCamera_RoomViewMode_VideoTransluscent"	"Transluscent Pass-Through"
"VRSettingsCamera_RoomViewMode_VideoOpaque"	"Opak Görünüm"
"[english]VRSettingsCamera_RoomViewMode_VideoOpaque"	"Opaque Pass-Through"
}
