"lang"
{
"Language"	"romanian"
"Tokens"
{
"VR_Map_Home"	"Radioland"
"[english]VR_Map_Home"	"Radioland"
"VR_Map_Home_Desc"	"Spațiul original pentru acasă din Destinations"
"[english]VR_Map_Home_Desc"	"The original Destinations home space."
"VR_Map_Mars"	"Marte"
"[english]VR_Map_Mars"	"Mars"
"VR_Map_Venice_Courtyard"	"Curte venețiană"
"[english]VR_Map_Venice_Courtyard"	"Venice Courtyard"
"VR_Map_Vesper_Peak"	"Vârful Vesper"
"[english]VR_Map_Vesper_Peak"	"Vesper Peak"
"VR_DynamicProp_Mars_Rover_Curiosity"	"Curiosity"
"[english]VR_DynamicProp_Mars_Rover_Curiosity"	"Curiosity"
"ContentBrowser_Title"	"Medii"
"[english]ContentBrowser_Title"	"Environments"
"ContentBrowser_ItemName"	"{s:name}"
"[english]ContentBrowser_ItemName"	"{s:name}"
"ContentBrowser_Browse_Workshop"	"Vezi toate"
"[english]ContentBrowser_Browse_Workshop"	"View All"
"ContentBrowser_Tab_Maps"	"Destinații"
"[english]ContentBrowser_Tab_Maps"	"Environments"
"ContentBrowser_Tab_DynamicProps"	" "
"[english]ContentBrowser_Tab_DynamicProps"	""
"ContentBrowser_Tab_PhysicsProps"	" "
"[english]ContentBrowser_Tab_PhysicsProps"	""
"ContentBrowser_ShowTutorial"	"?"
"[english]ContentBrowser_ShowTutorial"	"?"
"ContentBrowser_Default"	"INCLUS"
"[english]ContentBrowser_Default"	"INCLUDED"
"ContentBrowser_Workshop"	"ATELIER STEAM"
"[english]ContentBrowser_Workshop"	"STEAM WORKSHOP"
"ContentBrowser_Local"	"FIȘIER LOCAL"
"[english]ContentBrowser_Local"	"LOCAL FILE"
"ContentBrowser_Controller_Detail_Hint"	"DETALII OBIECT"
"[english]ContentBrowser_Controller_Detail_Hint"	"ITEM DETAILS"
"ContentBrowser_Controller_Select_Hint"	"ALEGE"
"[english]ContentBrowser_Controller_Select_Hint"	"SELECT"
"ItemDetail_TypeLabel"	"Tip: "
"[english]ItemDetail_TypeLabel"	"Type: "
"ItemDetail_TypeDesc"	"{s:item_type}"
"[english]ItemDetail_TypeDesc"	"{s:item_type}"
"ItemDetail_Type_Map"	"Exemplu de destinație"
"[english]ItemDetail_Type_Map"	"Example Environment"
"ItemDetail_Type_IncludedAddon"	"Exemplu de destinație"
"[english]ItemDetail_Type_IncludedAddon"	"Example Environment"
"ItemDetail_Type_Addon"	"Destinație"
"[english]ItemDetail_Type_Addon"	"Environment"
"ItemDetail_Type_DynamicProp"	"Recuzită"
"[english]ItemDetail_Type_DynamicProp"	"Prop"
"ItemDetail_Type_PhysicsProp"	"Recuzită"
"[english]ItemDetail_Type_PhysicsProp"	"Prop"
"ItemDetail_ThemeLabel"	"Tema: "
"[english]ItemDetail_ThemeLabel"	"Theme: "
"ItemDetail_ThemeDesc"	"{s:item_theme}"
"[english]ItemDetail_ThemeDesc"	"{s:item_theme}"
"ItemDetail_Theme_None"	"Niciuna"
"[english]ItemDetail_Theme_None"	"None"
"ItemDetail_Name"	"{s:item_detail_name}"
"[english]ItemDetail_Name"	"{s:item_detail_name}"
"ItemDetail_Desc"	"{s:item_detail_desc}"
"[english]ItemDetail_Desc"	"{s:item_detail_desc}"
"ItemDetail_Desc_LocalContent"	"Acest conținut a fost găsit pe hard drive-ul computerului tău"
"[english]ItemDetail_Desc_LocalContent"	"This content was found on your computer's hard drive"
"ItemDetail_CreatedLabel"	"Creator: "
"[english]ItemDetail_CreatedLabel"	"Creator: "
"ItemDetail_CreatorName"	"{s:item_author}"
"[english]ItemDetail_CreatorName"	"{s:item_author}"
"ItemDetail_ViewInWorkshop"	"Atelier"
"[english]ItemDetail_ViewInWorkshop"	"Workshop"
"PlayerBillboard_Name"	"{s:player_name}"
"[english]PlayerBillboard_Name"	"{s:player_name}"
"WelcomePanel_Title"	"Bine ai venit!"
"[english]WelcomePanel_Title"	"Welcome!"
"WelcomePanel_PressMenuButton"	"Bine ai venit! \n\nApasă pe butonul „Menu” de pe controllerul tău pentru a începe."
"[english]WelcomePanel_PressMenuButton"	"Welcome! \n\nPress the Menu button on your controller to begin."
"DOTA_Workshop_Publish_WindowTitle"	"Publică în atelier"
"[english]DOTA_Workshop_Publish_WindowTitle"	"Workshop Publish"
"DOTA_Workshop_Publish_Title"	"Titlu:"
"[english]DOTA_Workshop_Publish_Title"	"Title:"
"DOTA_Workshop_Publish_Description"	"Descriere:"
"[english]DOTA_Workshop_Publish_Description"	"Description:"
"DOTA_Workshop_Publish_PreviewImage"	"Imagine de previzualizare:"
"[english]DOTA_Workshop_Publish_PreviewImage"	"Preview Image:"
"DOTA_Workshop_Publish_UploadSize"	"Dimensiunea încărcării:"
"[english]DOTA_Workshop_Publish_UploadSize"	"Upload Size:"
"DOTA_Workshop_Publish_ChangeLog"	"Jurnalul modificărilor:"
"[english]DOTA_Workshop_Publish_ChangeLog"	"Change Log:"
"DOTA_Workshop_Publish_Visibility"	"Vizibilitate"
"[english]DOTA_Workshop_Publish_Visibility"	"Visibility"
"DOTA_Workshop_Publish_Visibility_FriendsOnly"	"Doar prieteni"
"[english]DOTA_Workshop_Publish_Visibility_FriendsOnly"	"Friends-Only"
"DOTA_Workshop_Publish_Visibility_Hidden"	"Ascuns"
"[english]DOTA_Workshop_Publish_Visibility_Hidden"	"Hidden"
"DOTA_Workshop_Publish_AcceptAgreement"	"Sunt de acord cu termenii Acordului de Contribuție al Atelierului Steam."
"[english]DOTA_Workshop_Publish_AcceptAgreement"	"I accept the terms of the Steam Workshop Contribution Agreement."
"DOTA_Workshop_Publish_ViewAgreement"	"Citește acordul"
"[english]DOTA_Workshop_Publish_ViewAgreement"	"View Agreement"
"DOTA_Workshop_Publish_Cancel"	"Anulare"
"[english]DOTA_Workshop_Publish_Cancel"	"Cancel"
"DOTA_Workshop_Publish_CancelTitle"	"Anulezi încărcarea fișierului?"
"[english]DOTA_Workshop_Publish_CancelTitle"	"Cancel File Upload?"
"DOTA_Workshop_Publish_CancelQuestion"	"Ești sigur că vrei să anulezi încărcarea fișierului?"
"[english]DOTA_Workshop_Publish_CancelQuestion"	"Are you sure you want to cancel file upload?"
"DOTA_Workshop_Publish_Submit"	"Trimite"
"[english]DOTA_Workshop_Publish_Submit"	"Submit"
"DOTA_Workshop_Publish_PrimaryOwnerPreview"	"Doar proprietarul principal poate schimba imaginea de previzualizare."
"[english]DOTA_Workshop_Publish_PrimaryOwnerPreview"	"Only the primary owner can change the preview image"
"DOTA_Workshop_Publish_BrowseForImage"	"Răsfoiește după o imagine"
"[english]DOTA_Workshop_Publish_BrowseForImage"	"Browse for image"
"DOTA_Workshop_Publish_ImageInstruction"	"Trage o imagine aici sau apasă pe butonul \"Răsfoiește\"\nImaginea va fi micșorată la %1"
"[english]DOTA_Workshop_Publish_ImageInstruction"	"Drag an image here or click the Browse button\nImage will be scaled to %1"
"DOTA_Workshop_Publish_UpdateNotesInstruction"	"Scrie-ți notițele de actualizare pentru această schimbare aici"
"[english]DOTA_Workshop_Publish_UpdateNotesInstruction"	"Type your update notes for this change here"
"DOTA_Workshop_Publish_ChooseImage"	"Alege o imagine"
"[english]DOTA_Workshop_Publish_ChooseImage"	"Choose Image"
"DOTA_Workshop_Publish_ImageFilter"	"Fișiere de imagine"
"[english]DOTA_Workshop_Publish_ImageFilter"	"Image Files"
"DOTA_Workshop_Publish_CancelUpload"	"Anulează încărcarea fișierului?"
"[english]DOTA_Workshop_Publish_CancelUpload"	"Cancel File Upload?"
"DOTA_Workshop_Publish_CancelUploadText"	"Ești sigur că vrei să oprești încărcarea fișierului?"
"[english]DOTA_Workshop_Publish_CancelUploadText"	"Are you sure you want to cancel file upload?"
"DOTA_Workshop_Publish_RetrievingInfo"	"Se obţin informaţii despre fişier..."
"[english]DOTA_Workshop_Publish_RetrievingInfo"	"Retrieving file information..."
"DOTA_Workshop_Publish_Submitting"	"Se trimite în Atelier"
"[english]DOTA_Workshop_Publish_Submitting"	"Submitting To Workshop"
"DOTA_Workshop_Publish_StatusWindowTitle_Items"	"Manager atelier [Obiecte]"
"[english]DOTA_Workshop_Publish_StatusWindowTitle_Items"	"Workshop Manager [Items]"
"DOTA_Workshop_Publish_Success"	"Succes"
"[english]DOTA_Workshop_Publish_Success"	"Success"
"DOTA_Workshop_Publish_SuccessMessage"	"Obiectul a fost încărcat în Atelierul Steam!"
"[english]DOTA_Workshop_Publish_SuccessMessage"	"The item has been uploaded to the Steam Workshop!"
"DOTA_Workshop_Publish_Updating"	"Se actualizează, te rugăm să aștepți..."
"[english]DOTA_Workshop_Publish_Updating"	"Updating, please wait..."
"DOTA_Workshop_Publish_SuccessTextNeedsToAccept"	"Obiectul a fost încărcat în Atelier, dar pentru a-l face vizibil altor utilizatori trebuie să accepți ultimul acord legal al Atelierului de pe pagina de web a Atelierului."
"[english]DOTA_Workshop_Publish_SuccessTextNeedsToAccept"	"The item has been uploaded to the Workshop, but to make it visible to other users you must accept the latest Workshop Legal Agreement on the Workshop webpage."
"DOTA_Workshop_Publish_FolderChangeTitle"	"Continuă încărcarea?"
"[english]DOTA_Workshop_Publish_FolderChangeTitle"	"Continue with upload?"
"DOTA_Workshop_Publish_UGCError"	"A avut loc o eroare în timp ce s-a încercat descărcarea unui fișier de pe serverul UGC!"
"[english]DOTA_Workshop_Publish_UGCError"	"An error occurred while attempting to download a file from the UGC server!"
"DOTA_Workshop_Publish_SuccessTitle"	"Succes"
"[english]DOTA_Workshop_Publish_SuccessTitle"	"Success"
"DOTA_Workshop_Publish_SuccessText"	"Acest obiect a fost actualizat în atelierul Steam!"
"[english]DOTA_Workshop_Publish_SuccessText"	"The item has been updated on the steam workshop!"
"DOTA_Workshop_Publish_Err_VPKAddFailed"	"Nu s-a putut crea obiectul nou pentru atelier (%1), nu s-a putut adăuga .vpk în directorul local."
"[english]DOTA_Workshop_Publish_Err_VPKAddFailed"	"Failed to create new workshop item (%1), could not add .vpk to local directory."
"DOTA_Workshop_Publish_Err_InvalidZip"	"Fișier Zip nevalid."
"[english]DOTA_Workshop_Publish_Err_InvalidZip"	"Invalid Zip File."
"DOTA_Workshop_Publish_Err_Title"	"Te rugăm să introduci un titlu"
"[english]DOTA_Workshop_Publish_Err_Title"	"Please enter a title"
"DOTA_Workshop_Publish_Err_NoDesc"	"Te rugăm să introduci o descriere"
"[english]DOTA_Workshop_Publish_Err_NoDesc"	"Please enter a description"
"DOTA_Workshop_Publish_Err_DescTooLong"	"Descrierea este prea lungă, limitează-te la %1 caractere"
"[english]DOTA_Workshop_Publish_Err_DescTooLong"	"The description is too long, limit to %1 characters"
"DOTA_Workshop_Publish_Err_NoChange"	"Te rugăm să introduci o descriere pentru schimbare"
"[english]DOTA_Workshop_Publish_Err_NoChange"	"Please enter a description for the change"
"DOTA_Workshop_Publish_Err_ChangeTooLong"	"Notițele de schimbări sunt prea lungi, limitează-te la %1 caractere"
"[english]DOTA_Workshop_Publish_Err_ChangeTooLong"	"The change notes are too long, limit to %1 characters"
"DOTA_Workshop_Publish_Err_NoFile"	"Te rugăm să alegi un fișier"
"[english]DOTA_Workshop_Publish_Err_NoFile"	"Please select a file"
"DOTA_Workshop_Publish_Err_NoPreview"	"Te rugăm să alegi o imagine de previzualizare"
"[english]DOTA_Workshop_Publish_Err_NoPreview"	"Please select a preview image"
"DOTA_Workshop_Publish_Err_NoVisibility"	"Selectează o opțiune de vizibilitate pentru obiectul tău."
"[english]DOTA_Workshop_Publish_Err_NoVisibility"	"Select a visibility option for your item."
"DOTA_Workshop_PublishFailure_SteamAPI"	"Eroare de publicare: a eșuat trimiterea obiectului"
"[english]DOTA_Workshop_PublishFailure_SteamAPI"	"Publish Failure: Failed To Submit Item"
"DOTA_Workshop_PublishFailure_SteamAPIResult"	"Publicarea a eșuat: eroare necunoscută"
"[english]DOTA_Workshop_PublishFailure_SteamAPIResult"	"Publish Failure: Unknown Error"
"DOTA_Workshop_PublishFailure_Password"	"Publicarea a eșuat: parolă greșită"
"[english]DOTA_Workshop_PublishFailure_Password"	"Publish Failure: Invalid Password"
"DOTA_Workshop_PublishFailure_NoConnection"	"Eșec la publicare: nicio conexiune"
"[english]DOTA_Workshop_PublishFailure_NoConnection"	"Publish Failure: No Connection"
"DOTA_Workshop_PublishFailure_Generic"	"Publicarea a eșuat: Codul erorii %1"
"[english]DOTA_Workshop_PublishFailure_Generic"	"Publish Failure: Error Code %1"
"DOTA_Workshop_PublishFailure_FailedToWritePreviewImage"	"Nu s-a putut scrie imaginea de previzualizare pe „%1”"
"[english]DOTA_Workshop_PublishFailure_FailedToWritePreviewImage"	"Failed to write preview image to '%1'"
"Workshop_UploadProgress_PreparingConfig"	"Se pregătește configurarea..."
"[english]Workshop_UploadProgress_PreparingConfig"	"Preparing configuration..."
"Workshop_UploadProgress_PreparingContent"	"Se procesează fișierele..."
"[english]Workshop_UploadProgress_PreparingContent"	"Processing files..."
"Workshop_UploadProgress_UploadingContent"	"Se încarcă fișierele..."
"[english]Workshop_UploadProgress_UploadingContent"	"Uploading files..."
"Workshop_UploadProgress_UploadingPreview"	"Se încarcă fișierele de previzualizare..."
"[english]Workshop_UploadProgress_UploadingPreview"	"Uploading preview files..."
"Workshop_UploadProgress_CommittingChanges"	"Se finalizează..."
"[english]Workshop_UploadProgress_CommittingChanges"	"Finishing up..."
"Workshop_Theme_Tags"	"Temă"
"[english]Workshop_Theme_Tags"	"Theme"
"Workshop_Tag_Theme_Abstract"	"Abstract"
"[english]Workshop_Tag_Theme_Abstract"	"Abstract"
"Workshop_Tag_Theme_Architecture"	"Architectură"
"[english]Workshop_Tag_Theme_Architecture"	"Architecture"
"Workshop_Tag_Theme_Art"	"Artă"
"[english]Workshop_Tag_Theme_Art"	"Art"
"Workshop_Tag_Theme_City"	"Oraș"
"[english]Workshop_Tag_Theme_City"	"City"
"Workshop_Tag_Theme_Game"	"Joc"
"[english]Workshop_Tag_Theme_Game"	"Game"
"Workshop_Tag_Theme_Nature"	"Natură"
"[english]Workshop_Tag_Theme_Nature"	"Nature"
"Workshop_Tag_Theme_Space"	"Spațiu"
"[english]Workshop_Tag_Theme_Space"	"Space"
"Workshop_Tag_Theme_Tech"	"Tehnologie"
"[english]Workshop_Tag_Theme_Tech"	"Tech"
"Workshop_Tag_Theme_Real"	"Real"
"[english]Workshop_Tag_Theme_Real"	"Real"
"Workshop_Tag_Theme_Imaginary"	"Imaginar"
"[english]Workshop_Tag_Theme_Imaginary"	"Imaginary"
"Workshop_Tag_Theme_SmallThings"	"Lucruri mici"
"[english]Workshop_Tag_Theme_SmallThings"	"Small Things"
"Workshop_Tag_Theme_BigThings"	"Lucruri mari"
"[english]Workshop_Tag_Theme_BigThings"	"Big Things"
"TutorialPage1_Title"	"Mișcarea în Destinații"
"[english]TutorialPage1_Title"	"Moving around in Destinations"
"TutorialPage2_Title"	"Utilizarea recuzitelor în Destinații"
"[english]TutorialPage2_Title"	"Using Props in Destinations"
"TutorialPage1_Tile1_Desc"	"Pentru a te teleporta, apasă și ține apăsat butonul trackpadului."
"[english]TutorialPage1_Tile1_Desc"	"To teleport, press down and hold the trackpad button."
"TutorialPage1_Tile3_Desc"	"Eliberează butonul trackpadului pentru a te teleporta la cercul verde."
"[english]TutorialPage1_Tile3_Desc"	"Release the trackpad button to teleport to the green circle."
"TutorialPage_Next"	"Următorul"
"[english]TutorialPage_Next"	"Next"
"TutorialPage_Done"	"Gata"
"[english]TutorialPage_Done"	"Done"
"TutorialPage1_Tile1_Controller_Desc"	"Pentru a te teleporta, apasă și ține apăsat triggerul drept."
"[english]TutorialPage1_Tile1_Controller_Desc"	"To teleport, press and hold the right trigger."
"TutorialPage2_Tile2_Controller_Desc"	"Aici poți răsfoi și naviga către alte Destinații folosind butonul A."
"[english]TutorialPage2_Tile2_Controller_Desc"	"Here you can navigate to and browse other Destinations using the A button."
"Mars_ApproachTitle"	"Apropiere"
"[english]Mars_ApproachTitle"	"Approach"
"Mars_DunesTitle"	"Dune"
"[english]Mars_DunesTitle"	"Dunes"
"Mars_ExitTitle"	"Ieșire"
"[english]Mars_ExitTitle"	"Exit"
"EnglishChurch_CaptureTitle"	"Capturează"
"[english]EnglishChurch_CaptureTitle"	"Capture"
"EnglishChurch_ExposureTitle"	"Cameră"
"[english]EnglishChurch_ExposureTitle"	"Camera"
"EnglishChurch_NotHDR2Title"	"Umbre"
"[english]EnglishChurch_NotHDR2Title"	"Shadows"
"EnglishChurch_ViewDirectionTitle"	"Vezi direcția"
"[english]EnglishChurch_ViewDirectionTitle"	"View Direction"
"EnglishChurch_VegetationTitle"	"Vegetație"
"[english]EnglishChurch_VegetationTitle"	"Vegetation"
"EnglishChurch_CleanupTitle"	"Curățenie"
"[english]EnglishChurch_CleanupTitle"	"Cleanup"
"EnglishChurch_StatisticsTitle"	"Statistici"
"[english]EnglishChurch_StatisticsTitle"	"Statistics"
"EnglishChurch_CameraPositionsTitle"	"Pozițiile camerei"
"[english]EnglishChurch_CameraPositionsTitle"	"Camera Positions"
"EnglishChurch_CameraPositions_TurnOn"	"Afișează pozițiile camerei"
"[english]EnglishChurch_CameraPositions_TurnOn"	"Show Camera Positions"
"EnglishChurch_CameraPositions_TurnOff"	"Ascunde pozițiile camerei"
"[english]EnglishChurch_CameraPositions_TurnOff"	"Hide Camera Positions"
"Mars_ImageGlitches_TurnOn"	"Afișează pozițiile camerei"
"[english]Mars_ImageGlitches_TurnOn"	"Show Camera Positions"
"Mars_ImageGlitches_TurnOff"	"Ascunde pozițiile camerei"
"[english]Mars_ImageGlitches_TurnOff"	"Hide Camera Positions"
"ItemDetail_LaunchDestination"	"Vizitează de unul singur"
"[english]ItemDetail_LaunchDestination"	"Visit On My Own"
"ContentBrowser_Tab_Avatars"	"Avatare"
"[english]ContentBrowser_Tab_Avatars"	"Avatars"
"ContentBrowser_Tab_Props"	"Recuzite"
"[english]ContentBrowser_Tab_Props"	"Props"
"ItemDetail_Type_Avatar"	"Avatar"
"[english]ItemDetail_Type_Avatar"	"Avatar"
"Friends_Title"	"Prieteni"
"[english]Friends_Title"	"Friends"
"Friends_Status"	"În joc"
"[english]Friends_Status"	"In-Game"
"Friends_Game"	"Prieten vechi"
"[english]Friends_Game"	"Old Friend"
"Friends_Button_Call"	"Apelează"
"[english]Friends_Button_Call"	"Call"
"Friends_Button_Invite"	"Invită aici"
"[english]Friends_Button_Invite"	"Invite Here"
"Friends_Button_Join"	"Alătură-te"
"[english]Friends_Button_Join"	"Join"
"Friends_Offline"	"Offline"
"[english]Friends_Offline"	"Offline"
"Friends_Online"	"Online"
"[english]Friends_Online"	"Online"
"Friends_Away"	"(Plecat)"
"[english]Friends_Away"	"(Away)"
"Friends_InGame"	"În joc"
"[english]Friends_InGame"	"In Game"
"FriendsInDestinations"	"Destinations"
"[english]FriendsInDestinations"	"Destinations"
"UnsubscribeLabel"	"Dezabonare"
"[english]UnsubscribeLabel"	"Unsubscribe"
"VR_Avatar_BaseAvatar"	"Avatar de bază"
"[english]VR_Avatar_BaseAvatar"	"Basic Avatar"
"VR_Avatar_BaseAvatar_Desc"	"Un avatar simplu care poate fi personalizat"
"[english]VR_Avatar_BaseAvatar_Desc"	"A simple, customizable avatar"
"ToggleHeadText"	"Cap"
"[english]ToggleHeadText"	"Head"
"ToggleHandsText"	"Mâini"
"[english]ToggleHandsText"	"Hands"
"Customize_Avatar_Title"	"Personalizează avatarul"
"[english]Customize_Avatar_Title"	"Customize Avatar"
"SettingsPage1_Title"	"Setări"
"[english]SettingsPage1_Title"	"Settings"
"SettingsPage_Done"	"Gata"
"[english]SettingsPage_Done"	"Done"
"Friends_InDestinations"	"În SteamVR"
"[english]Friends_InDestinations"	"In SteamVR"
"Friends_Destination"	"Vizitează {s:destination_title}"
"[english]Friends_Destination"	"Visiting {s:destination_title}"
"Friends_LobbyInvite"	"{s:name} te-a invitat să te alături camerei lui."
"[english]Friends_LobbyInvite"	"{s:name} has invited you to join their Room."
"Friends_Invited"	"Invitația a fost trimisă"
"[english]Friends_Invited"	"Invitation Sent"
"Friends_Button_AcceptInvite"	"Acceptă"
"[english]Friends_Button_AcceptInvite"	"Accept"
"Friends_Button_DeclineInvite"	"Ignoră"
"[english]Friends_Button_DeclineInvite"	"Ignore"
"CustomizeHeadText"	"Culoarea capului"
"[english]CustomizeHeadText"	"Head Color"
"CustomizeHandsText"	"Culoarea mâinii"
"[english]CustomizeHandsText"	"Hand Color"
"Avatar_Customization_Value_Hue"	"COLOR"
"[english]Avatar_Customization_Value_Hue"	"COLOR"
"Avatar_Customization_Value_Saturation"	"SATURAȚIE"
"[english]Avatar_Customization_Value_Saturation"	"SATURATION"
"Avatar_Customization_Value_Brightness"	"LUMINOZITATE"
"[english]Avatar_Customization_Value_Brightness"	"BRIGHTNESS"
"VR_Avatar_Head_Default"	"Headset implicit"
"[english]VR_Avatar_Head_Default"	"Default Headset"
"VR_Avatar_A"	"Cap - Rotund"
"[english]VR_Avatar_A"	"Head - Round"
"VR_Avatar_A_Desc"	"Un cap pentru avatar simplu și rotund."
"[english]VR_Avatar_A_Desc"	"A simple, round avatar head."
"VR_Avatar_D"	"Cap - Plat"
"[english]VR_Avatar_D"	"Head - Flat"
"VR_Avatar_E"	"Cap - Ou"
"[english]VR_Avatar_E"	"Head - Egg"
"VR_Avatar_F"	"Cap - Fus"
"[english]VR_Avatar_F"	"Head - Spindle"
"VR_Avatar_G"	"Cap - Puc"
"[english]VR_Avatar_G"	"Head - Puck"
"VR_Avatar_I"	"Cap - Mic"
"[english]VR_Avatar_I"	"Head - Small"
"VR_Avatar_Hand_Default"	"Controllere Vive"
"[english]VR_Avatar_Hand_Default"	"Vive controllers"
"VR_Avatar_Hand_Desc"	"Mâini simple."
"[english]VR_Avatar_Hand_Desc"	"Simple hands."
"Friends_Button_CancelDownload"	"Anulare"
"[english]Friends_Button_CancelDownload"	"Cancel"
"Destinations_WelcomeText"	"Bine ai venit!"
"[english]Destinations_WelcomeText"	"Welcome!"
"Notification_PlayerRemoved"	"{s:player_name} a părăsit camera"
"[english]Notification_PlayerRemoved"	"{s:player_name} has left the room"
"VR_PhysicsProp_BeachBall2"	"Minge de plajă"
"[english]VR_PhysicsProp_BeachBall2"	"Beach Ball"
"VR_PhysicsProp_BeachBall2_Desc"	"O zi la plajă nu ar fi completă fără una."
"[english]VR_PhysicsProp_BeachBall2_Desc"	"A day at the beach wouldn't be complete without one."
"FriendsControllerHintText"	"Uită-te aici și apasă (A) pentru a deschide."
"[english]FriendsControllerHintText"	"Look here and press (A) to open."
"AvatarControllerHintText"	"Uită-te aici și apasă (A) pentru a deschide."
"[english]AvatarControllerHintText"	"Look here and press (A) to open."
"Controller_AcceptInvite"	"PENTRU A ACCEPTA"
"[english]Controller_AcceptInvite"	"TO ACCEPT"
"Controller_DeclineInvite"	"PENTRU A IGNORA"
"[english]Controller_DeclineInvite"	"TO IGNORE"
"Controller_CancelDownload"	"PENTRU A ANULA"
"[english]Controller_CancelDownload"	"TO CANCEL"
"SortByDescription"	"Sortare după:"
"[english]SortByDescription"	"Sort by:"
"SortFavorites"	"Preferate"
"[english]SortFavorites"	"Favorites"
"SortAlphabetical"	"Alfabetic"
"[english]SortAlphabetical"	"A to Z"
"SortUpdated"	"Actualizat"
"[english]SortUpdated"	"Updated"
"SortRecent"	"Recent"
"[english]SortRecent"	"Recent"
"SetFavoriteButtonTitle"	"Preferat"
"[english]SetFavoriteButtonTitle"	"Favorite"
"IsFavoriteButtonTitle"	"Preferat"
"[english]IsFavoriteButtonTitle"	"Favorited"
"IsFavoriteButtonHover"	"Şterge din preferate"
"[english]IsFavoriteButtonHover"	"Unfavorite"
"FriendsTabText"	"Prieteni"
"[english]FriendsTabText"	"Friends"
"LobbiesTabText"	"Camere"
"[english]LobbiesTabText"	"Rooms"
"MuteOtherPlayers"	"Amuțește alți jucători"
"[english]MuteOtherPlayers"	"Mute Other Players"
"MuteMyself"	"Amuțește-te"
"[english]MuteMyself"	"Mute Myself"
"SetStatus"	"Setează starea:"
"[english]SetStatus"	"Set Status:"
"StatusOnline"	"Online"
"[english]StatusOnline"	"Online"
"StatusAway"	"Plecat"
"[english]StatusAway"	"Away"
"StatusBusy"	"Ocupat"
"[english]StatusBusy"	"Busy"
"StatusOffline"	"Offline"
"[english]StatusOffline"	"Offline"
"FilterFavorites"	"Preferate"
"[english]FilterFavorites"	"Favorites"
"FilterUnplayed"	"Nejucat"
"[english]FilterUnplayed"	"Unplayed"
"VR_Map_La_Pedrera"	"La Pedrera"
"[english]VR_Map_La_Pedrera"	"La Pedrera"
"VR_Map_La_Pedrera_Desc"	"La Pedrera, cunoscută și sub denumirea de Casa Mila, e localizată în Barcelona, Spania. Clădirea a fost proiectată de către arhitectul Antoni Gaudi și a fost finalizată în 1912. Această scenă fotogrammetrică constă în numai una din curțile sale interioare."
"[english]VR_Map_La_Pedrera_Desc"	"La Pedrera, also known as Casa Mila, is located in Barcelona, Spain.  The building was designed by the architect Antoni Gaudi and was completed in 1912.  This photogrammetry scene consists only of one of the inner courtyards."
"VR_PhysicsProp_Earth"	"Pământ"
"[english]VR_PhysicsProp_Earth"	"Earth"
"VR_PhysicsProp_Lizard"	"Șopârlă"
"[english]VR_PhysicsProp_Lizard"	"Lizard"
"VR_PhysicsProp_Medkit"	"Trusă medicală"
"[english]VR_PhysicsProp_Medkit"	"Medkit"
"HidePlayerNames"	"Ascunde numele jucătorilor"
"[english]HidePlayerNames"	"Hide Player Names"
"Controller_Join"	"PENTRU ALĂTURARE"
"[english]Controller_Join"	"TO JOIN"
"LobbyMember_Button_Mute"	"Amuțește"
"[english]LobbyMember_Button_Mute"	"Mute"
"LobbyMember_Button_Unmute"	"Activează vocea"
"[english]LobbyMember_Button_Unmute"	"Unmute"
"LobbyMember_Button_Add"	"Adaugă"
"[english]LobbyMember_Button_Add"	"Add"
"Lobby_OwnerName"	"Găzduit de {s:name}"
"[english]Lobby_OwnerName"	"Hosted by {s:name}"
"Lobby_OwnerLocation"	"{s:location}"
"[english]Lobby_OwnerLocation"	"{s:location}"
"Lobby_Destination"	"{s:destination_title}"
"[english]Lobby_Destination"	"{s:destination_title}"
"Lobby_MemberCount"	"{d:members} jucători"
"[english]Lobby_MemberCount"	"{d:members} players"
"Lobby_FriendCount"	"({d:members} prieteni)"
"[english]Lobby_FriendCount"	"({d:members} friends)"
"Lobby_Join"	"Alătură-te camerei"
"[english]Lobby_Join"	"Join Room"
"Lobby_Leave"	"Părăsește camera aceasta"
"[english]Lobby_Leave"	"Leave This Room"
"Lobby_Button_CancelDownload"	"Anulare"
"[english]Lobby_Button_CancelDownload"	"Cancel"
"LobbiesLeaveLobby"	"Părăsește camera aceasta"
"[english]LobbiesLeaveLobby"	"Leave This Room"
"WelcomePanel_PressYButton"	"Bun venit! \n\nAsigură-te că fereastra jocului SteamVR este activă pe computerul tău și apasă butonul Y de pe controller pentru a începe."
"[english]WelcomePanel_PressYButton"	"Welcome! \n\nMake sure the SteamVR game window is active on your computer, and press the Y button on your controller to begin."
"TutorialWelcome_Title"	"Bine ai venit!"
"[english]TutorialWelcome_Title"	"Welcome!"
"TutorialWelcome_Tile1_Desc"	"Bine ai venit în SteamVR!"
"[english]TutorialWelcome_Tile1_Desc"	"Welcome to SteamVR Home! This is your home space."
"TutorialMenu_Title"	"Folosirea meniului pentru destinații"
"[english]TutorialMenu_Title"	"Using the Destinations Menu"
"TutorialMenu_Tile2_Desc"	"Browserul îți oferă acces la destinații, recuzite și avatare."
"[english]TutorialMenu_Tile2_Desc"	"The Browser gives you access to Destinations, Props, and Avatars."
"TutorialMenu_Tile3_Desc"	"Panoul social îți permite să te întâlnești cu alți jucători în Destinations."
"[english]TutorialMenu_Tile3_Desc"	"The Social panel lets you meet up with other players in Destinations."
"TutorialWelcome_Tile1_Controller_Desc"	"Bine ai venit!"
"[english]TutorialWelcome_Tile1_Controller_Desc"	"Welcome!"
"TutorialTeleport_Tile1_Controller_Desc"	"Pentru a te teleporta, apasă și ține apăsat triggerul dreapta."
"[english]TutorialTeleport_Tile1_Controller_Desc"	"To teleport, press and hold the right trigger."
"ValveLobby_IntroTitle"	"Bine ai venit"
"[english]ValveLobby_IntroTitle"	"Welcome"
"ValveLobby_TrophiesTitle"	"Trofee"
"[english]ValveLobby_TrophiesTitle"	"Trophies"
"ValveLobby_MagazinesTitle"	"Reviste"
"[english]ValveLobby_MagazinesTitle"	"Magazines"
"ValveLobby_CSMagazinesTitle"	"Counter-Strike"
"[english]ValveLobby_CSMagazinesTitle"	"Counter-Strike"
"LaPedrera_IntroTitle"	"La Pedrera"
"[english]LaPedrera_IntroTitle"	"La Pedrera"
"LaPedrera_CourtyardTitle"	"Curtea La Pedrera"
"[english]LaPedrera_CourtyardTitle"	"La Pedrera Courtyard"
"ArcadeToss_ScoreRed"	"ECHIPA ROȘIE"
"[english]ArcadeToss_ScoreRed"	"TEAM RED"
"ArcadeToss_ScoreBlue"	"ECHIPA ALBASTRĂ"
"[english]ArcadeToss_ScoreBlue"	"TEAM BLUE"
"ArcadeToss_ScoreRedWins"	"ECHIPA ROȘIE A CÂȘTIGAT!"
"[english]ArcadeToss_ScoreRedWins"	"TEAM RED WINS!"
"ArcadeToss_ScoreBlueWins"	"ECHIPA ALBASTRĂ A CÂȘTIGAT!"
"[english]ArcadeToss_ScoreBlueWins"	"TEAM BLUE WINS!"
"ArcadeToss_ScoreTied"	"ECHIPELE SUNT LA EGALITATE!"
"[english]ArcadeToss_ScoreTied"	"TEAMS HAVE TIED!"
"LobbiesDescription"	"Selectează \"Deschis publicului\" pentru a deschide destinația ta actuală publicului și a permite altor jucători să ți se alăture aici."
"[english]LobbiesDescription"	"Hosting a Room allows other players to join you in this environment."
"ItemDetail_Select"	"Selectează"
"[english]ItemDetail_Select"	"Select"
"SubscribeLabel"	"Abonează-te"
"[english]SubscribeLabel"	"Subscribe"
"Lobby_Close"	"Închide camera aceasta"
"[english]Lobby_Close"	"Close This Room"
"BrowseDestinationsTitle"	"Locuri"
"[english]BrowseDestinationsTitle"	"Environments"
"BrowseAvatarsTitle"	"Avatarul meu"
"[english]BrowseAvatarsTitle"	"My Avatar"
"BackButtonText"	"Înapoi"
"[english]BackButtonText"	"Back"
"Dashboard_Avatars_1"	"PERSONALIZEAZĂ"
"[english]Dashboard_Avatars_1"	"CUSTOMIZE"
"Dashboard_Props_2"	"LUCRURI"
"[english]Dashboard_Props_2"	"THINGS"
"Dashboard_Workshop_1"	"RĂSFOIEȘTE"
"[english]Dashboard_Workshop_1"	"BROWSE"
"Dashboard_Workshop_2"	"Mai multe"
"[english]Dashboard_Workshop_2"	"Get More"
"ItemDetail_Ratings_Desc"	"{d:item_num_ratings} {s:item_rating_text}"
"[english]ItemDetail_Ratings_Desc"	"{d:item_num_ratings} {s:item_rating_text}"
"Dashboard_Currently"	"MOMENTAN VIZITEZI:"
"[english]Dashboard_Currently"	"Currently Visiting:"
"Current_Destination"	"{s:current_destination}"
"[english]Current_Destination"	"{s:current_destination}"
"BrowseWorkshop_ViewInWorkshop"	"Detalii"
"[english]BrowseWorkshop_ViewInWorkshop"	"Details"
"DownloadMessage"	"Conținutul tău se descarcă acum."
"[english]DownloadMessage"	"Your content is downloading now."
"Controller_WorkshopSubscribe"	"PENTRU A TE ABONA"
"[english]Controller_WorkshopSubscribe"	"TO SUBSCRIBE"
"Controller_WorkshopUnSubscribe"	"PENTRU A TE DEZABONA"
"[english]Controller_WorkshopUnSubscribe"	"TO UNSUBSCRIBE"
"Controller_WorkshopDetails"	"PENTRU DETALII"
"[english]Controller_WorkshopDetails"	"FOR DETAILS"
"SelfMutedLabel"	"Microfon oprit"
"[english]SelfMutedLabel"	"Microphone Off"
"OthersMutedLabel"	"Alți amuțiți"
"[english]OthersMutedLabel"	"Others Muted"
"Dashboard_Whats_New_Top"	"CE E NOU:"
"[english]Dashboard_Whats_New_Top"	"WHAT'S NEW:"
"DashboardNewsButton"	"Vezi ultimele știri"
"[english]DashboardNewsButton"	"See latest news"
"Avatar_Currently_Head"	"CAPUL CURENT:"
"[english]Avatar_Currently_Head"	"CURRENT HEAD:"
"Avatar_Currently_Hands"	"MÂINILE CURENTE:"
"[english]Avatar_Currently_Hands"	"CURRENT HANDS:"
"AvatarPreviewText"	"Previzualizarea avatarului meu"
"[english]AvatarPreviewText"	"My Avatar Preview"
"VR_Map_Jam_Session_Desc"	"Cântă la tobe, chitară sau la marimba cu prietenii tăi în Club Destinations!"
"[english]VR_Map_Jam_Session_Desc"	"Play the drums, the guitar, or the marimba with friends in Club Destinations!"
"VR_PhysicsProp_Pumpkin_01"	"Dovleac"
"[english]VR_PhysicsProp_Pumpkin_01"	"Pumpkin"
"VR_PhysicsProp_Toy_Soldier"	"Soldat de jucărie"
"[english]VR_PhysicsProp_Toy_Soldier"	"Toy Soldier"
"ConfirmationTitle"	"Ești sigur?"
"[english]ConfirmationTitle"	"Are you sure?"
"Notification_AvatarUnlocked"	"Ai deblocat avatarul \"{s:item_name}\"!"
"[english]Notification_AvatarUnlocked"	"You have unlocked the \"{s:item_name}\" avatar!"
"CannonWars_Blue_Desc1"	"Te-ai alăturat echipei albastre!"
"[english]CannonWars_Blue_Desc1"	"You are joining Team Blue!"
"CannonWars_Red_Desc1"	"Te-ai alăturat echipei roșii!"
"[english]CannonWars_Red_Desc1"	"You are joining Team Red!"
"#CannonWars_Blue_Wins"	"Echipa albastră a câștigat!"
"[english]#CannonWars_Blue_Wins"	"Blue Team Wins!"
"#CannonWars_Red_Wins"	"Echipa roșie a câștigat!"
"[english]#CannonWars_Red_Wins"	"Red Team Wins!"
"JamSession_Guitar_Free"	"MOD LIBER"
"[english]JamSession_Guitar_Free"	"FREE PLAY"
"JamSession_Guitar_Chord_CMajor"	"DO MAJOR"
"[english]JamSession_Guitar_Chord_CMajor"	"C MAJOR"
"JamSession_Guitar_Chord_FMajor"	"FA MAJOR"
"[english]JamSession_Guitar_Chord_FMajor"	"F MAJOR"
"JamSession_Guitar_Chord_GMajor"	"SOL MAJOR"
"[english]JamSession_Guitar_Chord_GMajor"	"G MAJOR"
"JamSession_Guitar_Chord_AMinor"	"LA MINOR"
"[english]JamSession_Guitar_Chord_AMinor"	"A MINOR"
"JamSession_Marimba_Title"	"Marimba"
"[english]JamSession_Marimba_Title"	"Marimba"
"JamSession_Drums_Title"	"Tobe"
"[english]JamSession_Drums_Title"	"Drums"
"JamSession_Drums_Free"	"MOD LIBER"
"[english]JamSession_Drums_Free"	"FREE PLAY"
"JamSession_Drums_Auto"	"MOD AUTOMAT"
"[english]JamSession_Drums_Auto"	"AUTOPLAY"
"Avatar_CurrentHead"	"{s:current_avatar_head}"
"[english]Avatar_CurrentHead"	"{s:current_avatar_head}"
"Avatar_CurrentHands"	"{s:current_avatar_hands}"
"[english]Avatar_CurrentHands"	"{s:current_avatar_hands}"
"TowerBridge_OverviewTitle"	"Tower Bridge, Londra"
"[english]TowerBridge_OverviewTitle"	"Tower Bridge, London"
"CannonWars_Blue_Wins"	"Echipa albastră a câștigat!"
"[english]CannonWars_Blue_Wins"	"Blue Team Wins!"
"CannonWars_Red_Wins"	"Echipa roșie a câștigat!"
"[english]CannonWars_Red_Wins"	"Red Team Wins!"
"SortPlayers"	"Jucători"
"[english]SortPlayers"	"Players"
"SortPopular"	"Populare"
"[english]SortPopular"	"Popular"
"SortPlaytime"	"Timp de joc"
"[english]SortPlaytime"	"Playtime"
"SortType"	"Tip"
"[english]SortType"	"Type"
"TagTitle"	"Filtrează după etichetă:"
"[english]TagTitle"	"Filter by Tag:"
"ToolsTag"	"Instrumente"
"[english]ToolsTag"	"Tools"
"VR_PhysicsProp_Balloonicorn"	"Balloonicorn"
"[english]VR_PhysicsProp_Balloonicorn"	"Balloonicorn"
"VR_PhysicsProp_Balloonicorn_Desc"	"Murr hurr mphuphurrur, hurr mph phrr.\n\nAșa cum apare și în Team Fortress 2."
"[english]VR_PhysicsProp_Balloonicorn_Desc"	"Murr hurr mphuphurrur, hurr mph phrr.\n\nAs seen in Team Fortress 2."
"VR_PhysicsProp_BaseballBat001"	"Bâtă de baseball"
"[english]VR_PhysicsProp_BaseballBat001"	"Baseball Bat"
"VR_PhysicsProp_BeachBall"	"Minge aniversară"
"[english]VR_PhysicsProp_BeachBall"	"Birthday Ball"
"VR_PhysicsProp_Dice"	"Zar cu șase fețe"
"[english]VR_PhysicsProp_Dice"	"Six-Sided Die"
"VR_PhysicsProp_Drum_Stick"	"Băț de tobă"
"[english]VR_PhysicsProp_Drum_Stick"	"Drumstick"
"VR_PhysicsProp_Drum_Stick_Desc"	"Simte ritmul, apoi fă ritmul."
"[english]VR_PhysicsProp_Drum_Stick_Desc"	"Feel the rhythm, then make the rhythm."
"VR_PhysicsProp_Fortification_Block"	"Bloc de fortificare"
"[english]VR_PhysicsProp_Fortification_Block"	"Fortification Block"
"VR_PhysicsProp_Helmet"	"Cască spațială"
"[english]VR_PhysicsProp_Helmet"	"Space Helmet"
"VR_PhysicsProp_Helmet_Desc"	"Încoronează-te drept regele spațiului!"
"[english]VR_PhysicsProp_Helmet_Desc"	"Crown yourself the king of space!"
"VR_PhysicsProp_Mars"	"Marte"
"[english]VR_PhysicsProp_Mars"	"Mars"
"VR_PhysicsProp_OilDrum"	"Butoi"
"[english]VR_PhysicsProp_OilDrum"	"Barrel"
"VR_PhysicsProp_OilDrum_Desc"	"Ce e înăuntru? Apă? Ciocolată? Un alt butoi mai mic? Lumea nu va ști niciodată."
"[english]VR_PhysicsProp_OilDrum_Desc"	"What's inside? Water? Chocolate? Another, smaller barrel? The world may never know."
"VR_PhysicsProp_PortalCake"	"Tort"
"[english]VR_PhysicsProp_PortalCake"	"Cake"
"VR_PhysicsProp_StorageCube"	"Cub de depozitare"
"[english]VR_PhysicsProp_StorageCube"	"Storage Cube"
"VR_PhysicsProp_Techies_Barrel"	"Techies"
"[english]VR_PhysicsProp_Techies_Barrel"	"Techies"
"VR_PropTool_CacheFinder"	"Detector de comori"
"[english]VR_PropTool_CacheFinder"	"Cache Finder"
"VR_PropTool_CacheFinder_Desc"	"Obține obiecte ascunse în medii diferite.\n\nMai întâi, uită-te în meniul de misiuni pentru a vedea unde poți găsi o comoară. După ce ajungi într-un loc probabil, urmărește semnalul detectorului de comori pentru a detecta obiectul ascuns. Apoi, declașează raza de capturare pentru a lua obiectul din mediu. Vânătoare plăcută!"
"[english]VR_PropTool_CacheFinder_Desc"	"Obtain items hidden in different environments.\n\nFirst, look in the Quest menu to see where you can find a cache. Once at a likely place, follow the Cache Finder's signals to detect the hidden item. Then, trigger its capture beam to pluck the item from the environment. Happy hunting!"
"VR_PropTool_Drone"	"Controller de dronă"
"[english]VR_PropTool_Drone"	"Drone Controller"
"VR_PropTool_CacheFinder_None"	"NICIO COMOARĂ ÎN APROPIERE"
"[english]VR_PropTool_CacheFinder_None"	"NO CACHE NEARBY"
"VR_PropTool_CacheFinder_Find"	"COMOARĂ ÎN APROPIERE"
"[english]VR_PropTool_CacheFinder_Find"	"CACHE NEARBY"
"VR_PropTool_CacheFinder_Catch"	"APUCĂ COMOARA"
"[english]VR_PropTool_CacheFinder_Catch"	"GRAB THE CACHE"
"VR_PropTool_CacheFinder_Pull"	"DESCHIDE UN PORTAL"
"[english]VR_PropTool_CacheFinder_Pull"	"OPEN A PORTAL"
"VR_PropTool_CacheFinder_Captured"	"COMOARA A FOST DEBLOCATĂ!"
"[english]VR_PropTool_CacheFinder_Captured"	"CACHE UNLOCKED!"
"VR_Avatar_TF2_Bot_Demo_Desc"	"„Am stat tot timpul cu ochiul meu bun pe tine!”"
"[english]VR_Avatar_TF2_Bot_Demo_Desc"	"'I had me good eye on you the whole time!'"
"VR_Avatar_TF2_Bot_Engineer_Desc"	"„Sunt un inginer - asta înseamnă că rezolv probleme.”"
"[english]VR_Avatar_TF2_Bot_Engineer_Desc"	"'I'm an engineer--that means I solve problems.'"
"VR_Avatar_TF2_Bot_Medic_Desc"	"„Să mergem să practicăm medicina.”"
"[english]VR_Avatar_TF2_Bot_Medic_Desc"	"'Let's go practice medicine.'"
"VR_Avatar_TF2_Bot_Pyro_Desc"	"„Mmph mphna mprh.”"
"[english]VR_Avatar_TF2_Bot_Pyro_Desc"	"'Mmph mphna mprh.'"
"VR_Avatar_TF2_Bot_Scout_Desc"	"„Ai idee cu cine vorbești?”"
"[english]VR_Avatar_TF2_Bot_Scout_Desc"	"'Do you have any idea who you're talking to?'"
"VR_Avatar_TF2_Bot_Sniper_Desc"	"„Meseria de lunetist e bună, amice!”"
"[english]VR_Avatar_TF2_Bot_Sniper_Desc"	"'Snipin's a good job, mate!'"
"VR_Avatar_TF2_Bot_Spy_Desc"	"„Domnilor.”"
"[english]VR_Avatar_TF2_Bot_Spy_Desc"	"'Gentlemen.'"
"VR_Avatar_Wearable_BasicSphere001"	"Sferă simplă"
"[english]VR_Avatar_Wearable_BasicSphere001"	"Simple Sphere"
"VR_Avatar_Wearable_BasicSphere001_Desc"	"O sferă simplă."
"[english]VR_Avatar_Wearable_BasicSphere001_Desc"	"A simple sphere."
"VR_Avatar_Wearable_BasicCube001"	"Cub simplu"
"[english]VR_Avatar_Wearable_BasicCube001"	"Simple Cube"
"VR_Avatar_Wearable_BasicCube001_Desc"	"Un cub simplu."
"[english]VR_Avatar_Wearable_BasicCube001_Desc"	"A simple cube."
"VR_Avatar_Wearable_BasicRectangle001"	"Bloc simplu"
"[english]VR_Avatar_Wearable_BasicRectangle001"	"Simple Block"
"VR_Avatar_Wearable_BasicRectangle001_Desc"	"Un bloc simplu."
"[english]VR_Avatar_Wearable_BasicRectangle001_Desc"	"A simple block."
"VR_Avatar_Wearable_BasicCylinder001"	"Cilindru simplu"
"[english]VR_Avatar_Wearable_BasicCylinder001"	"Simple Cylinder"
"VR_Avatar_Wearable_BasicCylinder001_Desc"	"Un cilindru simplu."
"[english]VR_Avatar_Wearable_BasicCylinder001_Desc"	"A simple cylinder."
"VR_Avatar_Wearable_BasicPyramid001"	"Piramidă simplă"
"[english]VR_Avatar_Wearable_BasicPyramid001"	"Simple Pyramid"
"VR_Avatar_Wearable_BasicPyramid001_Desc"	"O piramidă simplă."
"[english]VR_Avatar_Wearable_BasicPyramid001_Desc"	"A simple pyramid."
"VR_Avatar_Wearable_BasicDisc001"	"Disc simplu"
"[english]VR_Avatar_Wearable_BasicDisc001"	"Simple Disc"
"VR_Avatar_Wearable_BasicDisc001_Desc"	"Un disc simplu."
"[english]VR_Avatar_Wearable_BasicDisc001_Desc"	"A simple disc."
"VR_Avatar_Wearable_BasicPanel001"	"Panou simplu"
"[english]VR_Avatar_Wearable_BasicPanel001"	"Simple Panel"
"VR_Avatar_Wearable_BasicPanel001_Desc"	"Un panou simplu."
"[english]VR_Avatar_Wearable_BasicPanel001_Desc"	"A simple panel."
"VR_Avatar_Wearable_Mustache001"	"Față - Mustață"
"[english]VR_Avatar_Wearable_Mustache001"	"Face - Mustache"
"VR_Avatar_Wearable_CowboyHat001"	"Pălărie de cowboy"
"[english]VR_Avatar_Wearable_CowboyHat001"	"Cowboy Hat"
"VR_Avatar_Wearable_GyroCap001_Desc"	"„Hai să dăm o tură!”\n\nAșa cum apare și în Dota 2."
"[english]VR_Avatar_Wearable_GyroCap001_Desc"	"'Let's go for a spin!'\n\nAs seen in Dota 2."
"VR_Avatar_Wearable_HairMale007"	"Păr - Vampir"
"[english]VR_Avatar_Wearable_HairMale007"	"Hair - Vampire"
"VR_Avatar_Wearable_HairMale008"	"Păr - Perciuni"
"[english]VR_Avatar_Wearable_HairMale008"	"Hair - Sideburns"
"VR_Avatar_Wearable_HairMale008_Desc"	"O frizură cu perciuni."
"[english]VR_Avatar_Wearable_HairMale008_Desc"	"A hairstyle with sideburns."
"VR_Avatar_Wearable_JuggernautMask001"	"Masca lui Juggernaut"
"[english]VR_Avatar_Wearable_JuggernautMask001"	"Juggernaut Mask"
"VR_Avatar_Wearable_BaseballCap002"	"Pălărie Mann Co"
"[english]VR_Avatar_Wearable_BaseballCap002"	"Mann Co Hat"
"VR_Avatar_Wearable_Fedora001"	"Fedora"
"[english]VR_Avatar_Wearable_Fedora001"	"Fedora"
"VR_Avatar_Wearable_ClockwerkMask001"	"Masca lui Clockwerk"
"[english]VR_Avatar_Wearable_ClockwerkMask001"	"Clockwerk Mask"
"VR_Avatar_Wearable_ClockwerkMask001_Desc"	"„Este necesară asamblarea.”\n\nAșa cum apare și în Dota 2."
"[english]VR_Avatar_Wearable_ClockwerkMask001_Desc"	"'Some assembly required.'\n\nAs seen in Dota 2."
"VR_Avatar_Wearable_Monocle001"	"Monoclu"
"[english]VR_Avatar_Wearable_Monocle001"	"Monocle"
"Quest_Headcrab_Desc"	"Deblochează acest avatar interacționând cu ceva din lobby-ul Valve."
"[english]Quest_Headcrab_Desc"	"Unlock this avatar by interacting with something in the Valve Lobby."
"Quest_Medkit_Desc"	"Deblochează această recuzită interacționând cu ceva din lobby-ul Valve."
"[english]Quest_Medkit_Desc"	"Unlock this prop by interacting with something in the Valve Lobby."
"Quest_TechiesBarrel_Desc"	"Deblochează această recuzită interacționând cu ceva din lobby-ul Valve."
"[english]Quest_TechiesBarrel_Desc"	"Unlock this prop by interacting with something in the Valve Lobby."
"Quest_ToyGun_Desc"	"{d:num_visited}/10 vizitate\nVizitează 10 medii descărcate din atelier pentru a debloca acest instrument."
"[english]Quest_ToyGun_Desc"	"{d:num_visited}/10 Visited\nVisit 10 environments downloaded from the Workshop to unlock this tool."
"Quest_Detector"	"Misiunea săptămânală cu comori ascunse"
"[english]Quest_Detector"	"Weekly Geocaching Quest"
"QuestType_Detector"	"{d:quest_quantity} comori rămase"
"[english]QuestType_Detector"	"{d:quest_quantity} Caches Left"
"Quest_Detector_Complete"	"Toate comorile au fost găsite."
"[english]Quest_Detector_Complete"	"All Caches Found"
"Quest_Detector_Desc"	"Utilizează unealta pentru detectarea de comori pentru a localiza o comoară în următoarele medii:"
"[english]Quest_Detector_Desc"	"Use the Cache Finder Tool (found in 'Things') to locate a cache in one of the following environments:"
"Quest_Detector_Desc_Complete"	"Ai finalizat toate misiunile cu comori ascunse din această săptămână. Această misiune se resetează în fiecare miercuri la miez de noapte GMT."
"[english]Quest_Detector_Desc_Complete"	"You have completed all Geocaching Quests for the week. This quest resets every Wednesday night at midnight GMT."
"Quest_Name"	"{s:quest_name}"
"[english]Quest_Name"	"{s:quest_name}"
"Quest_Type"	"{s:quest_type}"
"[english]Quest_Type"	"{s:quest_type}"
"QuestItemDestinationName"	"{s:destination_name}"
"[english]QuestItemDestinationName"	"{s:destination_name}"
"BrowseHeadsTitle"	"Capete pentru avatar"
"[english]BrowseHeadsTitle"	"Avatar Heads"
"BrowseGetMoreTitle"	"Mai multe"
"[english]BrowseGetMoreTitle"	"Get More"
"BrowseAvatarsTitleWearables"	"Personalizează-ți avatarul"
"[english]BrowseAvatarsTitleWearables"	"Customize Your Avatar"
"Dashboard_Tutorial"	"Tutoriale"
"[english]Dashboard_Tutorial"	"Tutorials"
"Dashboard_Settings"	"Setări"
"[english]Dashboard_Settings"	"Settings"
"PrivateDetailLabel"	"Mediu din prezent:"
"[english]PrivateDetailLabel"	"Currently Visiting:"
"PrivateHostDetailLabel"	"Găzduiește o cameră privată"
"[english]PrivateHostDetailLabel"	"Hosting Private Room:"
"PrivateVisitDetailLabel"	"Vizitează o cameră privată"
"[english]PrivateVisitDetailLabel"	"Visiting Private Room:"
"PublicHostDetailLabel"	"Găzduiește o cam. publ."
"[english]PublicHostDetailLabel"	"Hosting Public Room:"
"PublicVisitDetailLabel"	"Vizitează o cameră publică"
"[english]PublicVisitDetailLabel"	"Visiting Public Room:"
"Dashboard_Whats_New_Title"	"Bine ai venit în SteamVR!"
"[english]Dashboard_Whats_New_Title"	"Welcome to SteamVR!"
"Dashboard_Destinations_1_Gamepad"	"EXPLOREAZĂ"
"[english]Dashboard_Destinations_1_Gamepad"	"EXPLORE"
"Dashboard_Destinations_2_Gamepad"	"Locuri"
"[english]Dashboard_Destinations_2_Gamepad"	"Environments"
"Dashboard_Avatars_1_Gamepad"	"PERSONALIZEAZĂ"
"[english]Dashboard_Avatars_1_Gamepad"	"CUSTOMIZE"
"Dashboard_Avatars_2"	"AVATARE"
"[english]Dashboard_Avatars_2"	"AVATARS"
"Dashboard_Avatars_2_Gamepad"	"Avatarul meu"
"[english]Dashboard_Avatars_2_Gamepad"	"My Avatar"
"Dashboard_Quests_Available"	"{d:num_available_quests} misiuni disponibile"
"[english]Dashboard_Quests_Available"	"{d:num_available_quests} Quests Available"
"AddWearablesButton"	"Accesorizează"
"[english]AddWearablesButton"	"Accessorize"
"Avatar_Outfit"	"Ținuta #{d:outfit_number}"
"[english]Avatar_Outfit"	"Outfit #{d:outfit_number}"
"Avatar_AdjustColor"	"Ajustează culoarea avatarului:"
"[english]Avatar_AdjustColor"	"Adjust Avatar Color:"
"Player_Number"	"{d:num_players}"
"[english]Player_Number"	"{d:num_players}"
"DestinationsInfoText"	"Selectează un mediu de mai jos pentru a-l explora."
"[english]DestinationsInfoText"	"Select an environment below to visit."
"DestinationsWorkshopInfoText"	"Selectează un mediu de mai jos pentru a te abona la acesta."
"[english]DestinationsWorkshopInfoText"	"Select an environment below to subscribe to."
"ItemDetail_Type_AvatarWearable"	"Accesoriu de avatar"
"[english]ItemDetail_Type_AvatarWearable"	"Avatar Accessory"
"ItemDetail_JoinPublicDestination"	"Alătură-te altor jucători"
"[english]ItemDetail_JoinPublicDestination"	"Join Other Players"
"ItemDetail_LaunchPublicDestination"	"Creează o cameră publică"
"[english]ItemDetail_LaunchPublicDestination"	"Create Public Room"
"Dashboard_LaunchPublicDestination"	"Alătură-te unei camere publice"
"[english]Dashboard_LaunchPublicDestination"	"Join Public Room"
"ItemDetail_MovePublicDestination"	"Mută camera aici"
"[english]ItemDetail_MovePublicDestination"	"Move Room Here"
"VisitLabel"	"Vizitează"
"[english]VisitLabel"	"Visit"
"DownloadingLabel"	"Se descarcă..."
"[english]DownloadingLabel"	"Downloading..."
"ConfirmationButtonGoHomeText"	"Acasă"
"[english]ConfirmationButtonGoHomeText"	"Go Home"
"InLobby_Destination"	"Ești aici"
"[english]InLobby_Destination"	"You are here"
"AvatarPreviewHover"	"Arăți bine!"
"[english]AvatarPreviewHover"	"You look great!"
"WelcomePanel_PressBButton"	"Bine ai venit în SteamVR! \n\nApasă butonul B sau Y pe controllerul tău pentru a începe."
"[english]WelcomePanel_PressBButton"	"Welcome to SteamVR! \n\nPress the B or Y button on your controller to begin."
"WelcomePanel_UpdateDescTouch"	"Bine ai venit în SteamVR! \n\nApasă butonul B sau Y pentru a naviga prin medii și a te întâlni cu prieteni.\n\nPentru a te abona la mai multe medii, selectează fila „Mai multe” din panoul de medii. Pentru mai mult ajutor, selectează butonul pentru ajutor."
"[english]WelcomePanel_UpdateDescTouch"	"Welcome to SteamVR! \n\nPress the B or Y button to browse environments and meet up with friends.\n\nTo subscribe to more environments, select the 'Get More' tab in the Environments panel. For more help, select the Help button."
"Notification_LobbyInvite"	"{s:player_name} te-a invitat în camera lor \nDeschide panoul social din meniu pentru a răspunde."
"[english]Notification_LobbyInvite"	"{s:player_name} has invited you to their room \nOpen the Social panel in the Menu to respond"
"Notification_UserUnlockedItem"	"{s:player_name} a deblocat \"{s:item_name}\"!"
"[english]Notification_UserUnlockedItem"	"{s:player_name} has unlocked \"{s:item_name}\"!"
"TutorialQuest_Title"	"Misiuni"
"[english]TutorialQuest_Title"	"Quests"
"TutorialWelcome_Tile1_Touch_Desc"	"Bine ai venit în SteamVR!"
"[english]TutorialWelcome_Tile1_Touch_Desc"	"Welcome to SteamVR!"
"TutorialWelcome_Tile3_Touch_Desc"	"Pentru a deschide sau a închide acest meniu, utilizează butonul B (sau Y) de pe controllerul tău."
"[english]TutorialWelcome_Tile3_Touch_Desc"	"To open and close this menu, use the B (or Y) button on your controller."
"TutorialWelcome_Touch_Bottom_Desc"	"Nu uita să vizitezi atelierul pentru a descărca mai multe medii de la comunitate."
"[english]TutorialWelcome_Touch_Bottom_Desc"	"Don't forget to visit the Workshop to download more environments from the community."
"TutorialTeleport_Tile1_Touch_Desc"	"Pentru a te teleporta, apasă înainte pe joystick."
"[english]TutorialTeleport_Tile1_Touch_Desc"	"To teleport, push forward on the joystick."
"TutorialTeleport_Tile2_Touch_Desc"	"Vei vedea un arc care se sfârșește cu un cerc verde pe sol."
"[english]TutorialTeleport_Tile2_Touch_Desc"	"You will see an arc that ends with a green circle on the ground."
"TutorialTeleport_Tile3_Touch_Desc"	"Dă drumul la joystick pentru a te teleporta la cercul verde."
"[english]TutorialTeleport_Tile3_Touch_Desc"	"Release the joystick to teleport to the green circle."
"SelfAudibleLabel"	"Microfon pornit"
"[english]SelfAudibleLabel"	"Microphone On"
"VR_PhysicsProp_Earth_Desc"	"Ești (probabil) aici."
"[english]VR_PhysicsProp_Earth_Desc"	"You are (probably) here."
"VR_PhysicsProp_Medkit_Desc"	"N-ai pastile? Nicio problemă! Notă: nu te vor vindeca în realitate.\n\nAșa cum apare în Left 4 Dead."
"[english]VR_PhysicsProp_Medkit_Desc"	"No pills? No problem! Note: Will not actually heal you.\n\nAs seen in Left 4 Dead."
"VR_PhysicsProp_Pumpkin_01_Desc"	"Un dovleac în forma sa înainte de a fi lanternă sau plăcintă.\n\nAșa cum apare în Team Fortress 2."
"[english]VR_PhysicsProp_Pumpkin_01_Desc"	"A pumpkin in its pre-lantern, pre-pie form.\n\nAs seen in Team Fortress 2."
"VR_PhysicsProp_Toy_Soldier_Desc"	"Pune în scenă schimbarea gărzii din siguranța relativă a propriului tău headset VR!"
"[english]VR_PhysicsProp_Toy_Soldier_Desc"	"Recreate the changing of the guard from the relative safety of your own VR headset!"
"Quest_Label"	" Misiune"
"[english]Quest_Label"	" Quest"
"TutorialPublic_Title"	"Camere publice"
"[english]TutorialPublic_Title"	"Public Rooms"
"TutorialProps_Title"	"Utilizarea recuzitelor"
"[english]TutorialProps_Title"	"Using Props"
"TutorialProps_Tile1_Desc"	"Recuzitele sunt accesate din panoul „Medii” din Dashboard."
"[english]TutorialProps_Tile1_Desc"	"Props are accessed from the Environments panel in the Dashboard."
"TutorialProps_Tile2_Desc"	"Creează o recuzită prin selectarea acesteia din meniu folosind triggerul tău."
"[english]TutorialProps_Tile2_Desc"	"Spawn a prop by selecting it from the menu with your trigger."
"TutorialProps_Tile3_Desc"	"Pentru a schimba mărimea recuzitelor, folosește ambele mâini. Pentru a schimba culoarea unei recuzite, apasă trackpadul în timp ce ții recuzita."
"[english]TutorialProps_Tile3_Desc"	"To scale props, use both hands. To change a prop's color, touch your trackpad while holding the prop."
"TutorialProps_Bottom_Desc"	"Trage și ține triggerul apăsat pentru a face ca o recuzită să apară direct în mâna ta.\nEliberează triggerul pentru a scăpa recuzita."
"[english]TutorialProps_Bottom_Desc"	"Pull and hold the trigger to spawn a prop directly into your hand.\nRelease the trigger to drop the prop."
"TutorialAvatar_Bottom_Desc"	"Până la patru ținute pot fi salvate folosind meniul de ținute din dashboardul avatarului."
"[english]TutorialAvatar_Bottom_Desc"	"Up to four outfits can be saved via the Outfit dropdown on the Avatar dashboard."
"WelcomeTutorialLabel"	"Bine ai venit"
"[english]WelcomeTutorialLabel"	"Welcome"
"MovingTutorialLabel"	"Mișcarea"
"[english]MovingTutorialLabel"	"Moving Around"
"QuestsTutorialLabel"	"Misiuni"
"[english]QuestsTutorialLabel"	"Quests"
"PublicTutorialLabel"	"Camere publice"
"[english]PublicTutorialLabel"	"Public Rooms"
"PropsTutorialLabel"	"Utilizarea recuzitelor"
"[english]PropsTutorialLabel"	"Using Props"
"ToolsTutorialLabel"	"Utilizarea instrumentelor"
"[english]ToolsTutorialLabel"	"Using Tools"
"AvatarTutorialLabel"	"Avatarul tău"
"[english]AvatarTutorialLabel"	"Your Avatar"
"VR_Avatar_Wearable_ParasiteHat001"	"Parazit"
"[english]VR_Avatar_Wearable_ParasiteHat001"	"Parasite"
"VR_Avatar_Wearable_Crown001"	"Coroană"
"[english]VR_Avatar_Wearable_Crown001"	"Crown"
"VR_Avatar_Wearable_StormSpiritHat001"	"Pălăria lui Storm Spirit"
"[english]VR_Avatar_Wearable_StormSpiritHat001"	"Storm Spirit Hat"
"VR_Avatar_Wearable_UndyingHelmet001"	"Casca lui Undying"
"[english]VR_Avatar_Wearable_UndyingHelmet001"	"Undying Helmet"
"VR_Avatar_Wearable_UndyingHelmet001_Desc"	"„Ai grijă la muște.”\n\nAșa cum apare și în Dota 2."
"[english]VR_Avatar_Wearable_UndyingHelmet001_Desc"	"'Watch out for flies.'\n\nAs seen in Dota 2."
"LeaveDestinationText"	"Părăsește camera"
"[english]LeaveDestinationText"	"Leave Room"
"Notification_ClientDisconnected"	"Te-ai deconectat de la această cameră publică. ({s:reason})"
"[english]Notification_ClientDisconnected"	"You have been disconnected from this Public Room. ({s:reason})"
"GameUI_ServerNoLobby"	"Nu ai premisiunea pentru a te conecta"
"[english]GameUI_ServerNoLobby"	"You do not have permission to connect"
"VR_Avatar_Wearable_Sombrero001"	"Sombrero"
"[english]VR_Avatar_Wearable_Sombrero001"	"Sombrero"
"VR_Avatar_Wearable_Sombrero001_Desc"	"Un sombrero mexican."
"[english]VR_Avatar_Wearable_Sombrero001_Desc"	"A Mexican sombrero."
"VR_Avatar_Wearable_Feather001"	"Pană"
"[english]VR_Avatar_Wearable_Feather001"	"Feather"
"VR_Avatar_Wearable_Feather001_Desc"	"O pană decorativă."
"[english]VR_Avatar_Wearable_Feather001_Desc"	"A decorative feather."
"VR_Avatar_Wearable_Flower001"	"Floare"
"[english]VR_Avatar_Wearable_Flower001"	"Flower"
"VR_Avatar_Wearable_Flower001_Desc"	"O floare decorativă."
"[english]VR_Avatar_Wearable_Flower001_Desc"	"A decorative flower."
"SpawnDisabledText"	"Obiectul este dezactivat în mediul acesta"
"[english]SpawnDisabledText"	"Item disabled in this environment"
"FurnitureTag"	"Mobilier"
"[english]FurnitureTag"	"Furniture"
"VR_Furniture_Book001"	"Carte"
"[english]VR_Furniture_Book001"	"Book"
"VR_Furniture_Book001_Desc"	"O carte de la editura Pandaul Leneș."
"[english]VR_Furniture_Book001_Desc"	"A book from the Lazy Panda Publishing Company."
"VR_Furniture_Bookshelf001"	"Raft de cărți"
"[english]VR_Furniture_Bookshelf001"	"Bookshelf"
"VR_Furniture_Bookshelf001_Desc"	"Un raft din lemn."
"[english]VR_Furniture_Bookshelf001_Desc"	"A wooden bookshelf."
"VR_Furniture_Chair001"	"Scaun"
"[english]VR_Furniture_Chair001"	"Chair"
"VR_Furniture_Chair001_Desc"	"Un scaun confortabil."
"[english]VR_Furniture_Chair001_Desc"	"A comfy chair."
"VR_Furniture_CordlessPhone001"	"Telefon fără fir"
"[english]VR_Furniture_CordlessPhone001"	"Cordless Phone"
"VR_Furniture_CordlessPhone001_Desc"	"O linie privată."
"[english]VR_Furniture_CordlessPhone001_Desc"	"A secure line."
"VR_Furniture_Desk001"	"Birou"
"[english]VR_Furniture_Desk001"	"Office Desk"
"VR_Furniture_Desk001_Desc"	"Un birou."
"[english]VR_Furniture_Desk001_Desc"	"An office desk."
"VR_Furniture_Door001"	"Ușă de siguranță"
"[english]VR_Furniture_Door001"	"Secure Door"
"VR_Furniture_Door001_Desc"	"O ușă cu un lacăt cu combinații."
"[english]VR_Furniture_Door001_Desc"	"A door with a combination lock."
"VR_Furniture_FilingCabinet001"	"Cartotecă"
"[english]VR_Furniture_FilingCabinet001"	"Filing Cabinet"
"VR_Furniture_FilingCabinet001_Desc"	"O cartotecă."
"[english]VR_Furniture_FilingCabinet001_Desc"	"A filing cabinet."
"VR_Furniture_Globe001"	"Glob"
"[english]VR_Furniture_Globe001"	"Globe"
"VR_Furniture_Globe001_Desc"	"Un glob."
"[english]VR_Furniture_Globe001_Desc"	"A globe."
"VR_Furniture_PictureFrame001"	"Ramă - Peisaj"
"[english]VR_Furniture_PictureFrame001"	"Frame - Landscape"
"VR_Furniture_PictureFrame001_Desc"	"O ramă pentru fotografii."
"[english]VR_Furniture_PictureFrame001_Desc"	"A picture frame."
"VR_Furniture_PictureFrame002"	"Ramă - Portret"
"[english]VR_Furniture_PictureFrame002"	"Frame - Portrait"
"VR_Furniture_PictureFrame002_Desc"	"O ramă pentru fotografii."
"[english]VR_Furniture_PictureFrame002_Desc"	"A picture frame."
"VR_Furniture_Safe001"	"Seif"
"[english]VR_Furniture_Safe001"	"Safe"
"VR_Furniture_Safe001_Desc"	"Un seif."
"[english]VR_Furniture_Safe001_Desc"	"A safe."
"VR_Furniture_Trunk001"	"Cutie de depozitare"
"[english]VR_Furniture_Trunk001"	"Storage Trunk"
"VR_Furniture_Trunk001_Desc"	"O cutie de depozitare."
"[english]VR_Furniture_Trunk001_Desc"	"A storage trunk."
"VR_Furniture_Wardrobe001"	"Șifonier"
"[english]VR_Furniture_Wardrobe001"	"Wardrobe"
"VR_Furniture_Wardrobe001_Desc"	"Un șifonier."
"[english]VR_Furniture_Wardrobe001_Desc"	"A wardrobe."
"VR_Furniture_DiningTable001"	"Masă de bucătărie"
"[english]VR_Furniture_DiningTable001"	"Dining Table"
"VR_Furniture_DiningTable001_Desc"	"O masă de bucătărie."
"[english]VR_Furniture_DiningTable001_Desc"	"A dining table."
"VR_Furniture_Sofa001"	"Canapea"
"[english]VR_Furniture_Sofa001"	"Sofa"
"VR_Furniture_Sofa001_Desc"	"O canapea."
"[english]VR_Furniture_Sofa001_Desc"	"A sofa."
"VR_Furniture_TwinBed001"	"Pat - Dublu"
"[english]VR_Furniture_TwinBed001"	"Bed - Twin"
"VR_Furniture_TwinBed001_Desc"	"Un pat dublu."
"[english]VR_Furniture_TwinBed001_Desc"	"A twin bed."
"VR_PropTool_FreezeMode"	"ÎNGHEAȚĂ"
"[english]VR_PropTool_FreezeMode"	"FREEZE"
"VR_PropTool_ThawMode"	"DEZGHEAȚĂ"
"[english]VR_PropTool_ThawMode"	"THAW"
"VR_PropTool_CloneMode"	"CLONEAZĂ"
"[english]VR_PropTool_CloneMode"	"CLONE"
"VR_PropTool_DeleteMode"	"ȘTERGE"
"[english]VR_PropTool_DeleteMode"	"DELETE"
"VR_Furniture_Counter001"	"Tejghea"
"[english]VR_Furniture_Counter001"	"Counter"
"VR_Furniture_Counter001_Desc"	"O tejghea pentru bucătărie sau baie."
"[english]VR_Furniture_Counter001_Desc"	"A counter for the kitchen or bath."
"VR_Furniture_Cabinet001Left"	"Dulap - Stânga"
"[english]VR_Furniture_Cabinet001Left"	"Cabinet - Left"
"VR_Furniture_Cabinet001Left_Desc"	"Un dulap cu mânerul în stânga."
"[english]VR_Furniture_Cabinet001Left_Desc"	"A cabinet with a handle on the left."
"VR_Furniture_Cabinet001Right"	"Dulap - Dreapta"
"[english]VR_Furniture_Cabinet001Right"	"Cabinet - Right"
"VR_Furniture_Cabinet001Right_Desc"	"Un dulap cu mânerul în dreapta."
"[english]VR_Furniture_Cabinet001Right_Desc"	"A cabinet with a handle on the right."
"VR_Furniture_Sink001"	"Chiuvetă"
"[english]VR_Furniture_Sink001"	"Sink"
"VR_Furniture_Sink001_Desc"	"O chiuvetă pentru bucătărie sau baie."
"[english]VR_Furniture_Sink001_Desc"	"A sink for the kitchen or bath."
"VR_Furniture_Fridge001"	"Frigider"
"[english]VR_Furniture_Fridge001"	"Fridge"
"VR_Furniture_Fridge001_Desc"	"Un frigider."
"[english]VR_Furniture_Fridge001_Desc"	"A refrigerator."
"VR_Furniture_Toilet001"	"Toaletă"
"[english]VR_Furniture_Toilet001"	"Toilet"
"VR_Furniture_Toilet001_Desc"	"O toaletă."
"[english]VR_Furniture_Toilet001_Desc"	"A toilet."
"VR_Furniture_Bathtub001"	"Cadă"
"[english]VR_Furniture_Bathtub001"	"Bathtub"
"VR_Furniture_Bathtub001_Desc"	"O cadă."
"[english]VR_Furniture_Bathtub001_Desc"	"A bathtub."
"VR_Furniture_Stand001"	"Suport TV"
"[english]VR_Furniture_Stand001"	"TV Stand"
"VR_Furniture_Stand001_Desc"	"Un suport pentru sistemul tău de divertisment."
"[english]VR_Furniture_Stand001_Desc"	"A stand for your entertainment system."
"VR_Furniture_HousePlant001"	"Plantă de interior"
"[english]VR_Furniture_HousePlant001"	"House Plant"
"VR_Furniture_HousePlant001_Desc"	"O plantă de interior."
"[english]VR_Furniture_HousePlant001_Desc"	"A house plant."
"Dashboard_Destinations_2"	"LOCURI"
"[english]Dashboard_Destinations_2"	"ENVIRONMENTS"
"ItemDetail_Author_You"	"Tu"
"[english]ItemDetail_Author_You"	"You"
"ItemDetail_Author_Valve"	"Valve"
"[english]ItemDetail_Author_Valve"	"Valve"
"TutorialTitle"	"Tutoriale"
"[english]TutorialTitle"	"Tutorials"
"ContentBrowser_SaveGame_Desc"	"O personalizare pentru {s:name}"
"[english]ContentBrowser_SaveGame_Desc"	"A customization for {s:name}"
"Save_Button"	"Salvează mediul acesta"
"[english]Save_Button"	"Save This Environment"
"ConfirmationSaveStateMessage"	"Astfel se va salva starea tuturor recuzitelor și obiectelor din acest mediu. Poți găsi și să încarci această stare salvată în panoul de medii."
"[english]ConfirmationSaveStateMessage"	"This will save the state of all props and items in this environment. You can find and load this saved state in the Environments panel."
"SaveButtonOKText"	"Salvează"
"[english]SaveButtonOKText"	"Save"
"Notification_GameSaved"	"Schimbările din acest mediu au fost salvate!"
"[english]Notification_GameSaved"	"Changes to this environment have been saved!"
"VR_PhysicsProp_StuffedAlligator"	"Aligator de pluș"
"[english]VR_PhysicsProp_StuffedAlligator"	"Stuffed Alligator"
"VR_PhysicsProp_StuffedAlligator_Desc"	"Un aligator de pluș."
"[english]VR_PhysicsProp_StuffedAlligator_Desc"	"A stuffed animal alligator."
"VR_PhysicsProp_StuffedElephant"	"Elefant de pluș"
"[english]VR_PhysicsProp_StuffedElephant"	"Stuffed Elephant"
"VR_PhysicsProp_StuffedElephant_Desc"	"Un elefant de pluș."
"[english]VR_PhysicsProp_StuffedElephant_Desc"	"A stuffed animal elephant."
"VR_PhysicsProp_StuffedGiraffe"	"Girafă de pluș"
"[english]VR_PhysicsProp_StuffedGiraffe"	"Stuffed Giraffe"
"VR_PhysicsProp_StuffedGiraffe_Desc"	"O girafă de pluș."
"[english]VR_PhysicsProp_StuffedGiraffe_Desc"	"A stuffed animal giraffe."
"VR_PhysicsProp_StuffedSnake"	"Șarpe de pluș"
"[english]VR_PhysicsProp_StuffedSnake"	"Stuffed Snake"
"VR_PhysicsProp_StuffedSnake_Desc"	"Un șarpe de pluș."
"[english]VR_PhysicsProp_StuffedSnake_Desc"	"A stuffed animal snake."
"VR_PhysicsProp_TidehunterToy001"	"Jucărie Tidehunter"
"[english]VR_PhysicsProp_TidehunterToy001"	"Tidehunter Toy"
"SmallBubble"	"MIC"
"[english]SmallBubble"	"SMALL"
"VR_Furniture_ComputerDesk001"	"Birou pentru calculator"
"[english]VR_Furniture_ComputerDesk001"	"Computer Desk"
"VR_Furniture_ComputerDesk001_Desc"	"Un birou pentru calculator."
"[english]VR_Furniture_ComputerDesk001_Desc"	"A computer desk."
"VR_Furniture_Monitor001"	"Monitor"
"[english]VR_Furniture_Monitor001"	"Monitor"
"VR_Furniture_Monitor001_Desc"	"Un monitor."
"[english]VR_Furniture_Monitor001_Desc"	"A monitor."
"VR_Furniture_DesktopPC001"	"Calculator"
"[english]VR_Furniture_DesktopPC001"	"Desktop PC"
"VR_Furniture_DesktopPC001_Desc"	"Un calculator."
"[english]VR_Furniture_DesktopPC001_Desc"	"A desktop PC."
"VR_Furniture_Keyboard001"	"Tastatură"
"[english]VR_Furniture_Keyboard001"	"Keyboard"
"VR_Furniture_Keyboard001_Desc"	"O tastatură pentru computer."
"[english]VR_Furniture_Keyboard001_Desc"	"A computer keyboard."
"VR_Furniture_Mousepad001"	"Mousepad"
"[english]VR_Furniture_Mousepad001"	"Mousepad"
"VR_Furniture_Mousepad001_Desc"	"Un mousepad."
"[english]VR_Furniture_Mousepad001_Desc"	"A mousepad."
"VR_Furniture_Mouse001"	"Mouse"
"[english]VR_Furniture_Mouse001"	"Mouse"
"VR_Furniture_Mouse001_Desc"	"Un mouse de calculator."
"[english]VR_Furniture_Mouse001_Desc"	"A computer mouse."
"VR_Furniture_DeskPhone001"	"Telefon de birou"
"[english]VR_Furniture_DeskPhone001"	"Desk Phone"
"VR_Furniture_DeskPhone001_Desc"	"Un telefon de birou."
"[english]VR_Furniture_DeskPhone001_Desc"	"A desk phone."
"VR_Furniture_OfficeStool001"	"Scaun de birou"
"[english]VR_Furniture_OfficeStool001"	"Office Stool"
"VR_Furniture_OfficeStool001_Desc"	"Un scaun de birou."
"[english]VR_Furniture_OfficeStool001_Desc"	"An office stool."
"VR_Furniture_CoffeeMug001"	"Cană de cafea"
"[english]VR_Furniture_CoffeeMug001"	"Coffee Mug"
"VR_Furniture_CoffeeMug001_Desc"	"O cană de cafea."
"[english]VR_Furniture_CoffeeMug001_Desc"	"A coffee mug."
"Player_Number_Label"	"Jucători"
"[english]Player_Number_Label"	" Players"
"PlayerBillboard_Mute"	"Amuțește"
"[english]PlayerBillboard_Mute"	"Mute"
"PlayerBillboard_Click"	"Apasă pentru opțiuni"
"[english]PlayerBillboard_Click"	"Click for Options"
"PrivateTutorialLabel"	"Camere private"
"[english]PrivateTutorialLabel"	"Private Rooms"
"SocialTutorialLabel"	"Etichetă socială"
"[english]SocialTutorialLabel"	"Social Etiquette"
"TutorialPrivate_Title"	"Camere private"
"[english]TutorialPrivate_Title"	"Private Rooms"
"SavedTag"	"Salvat"
"[english]SavedTag"	"Saved"
"BackgroundsTag"	"Fundaluri"
"[english]BackgroundsTag"	"Backgrounds"
"VR_Furniture_Couch001"	"Canapea"
"[english]VR_Furniture_Couch001"	"Couch"
"VR_Furniture_Couch001_Desc"	"O canapea."
"[english]VR_Furniture_Couch001_Desc"	"A couch."
"VR_Furniture_Pillow001"	"Pernă"
"[english]VR_Furniture_Pillow001"	"Pillow"
"VR_Furniture_TVStand001_Desc"	"Un stand TV."
"[english]VR_Furniture_TVStand001_Desc"	"A TV stand."
"VR_Furniture_FryingPan001_Desc"	"O tigaie."
"[english]VR_Furniture_FryingPan001_Desc"	"A frying pan."
"VR_Furniture_Spatula001"	"Spatulă"
"[english]VR_Furniture_Spatula001"	"Spatula"
"VR_Furniture_Spatula001_Desc"	"O spatulă."
"[english]VR_Furniture_Spatula001_Desc"	"A spatula."
"VR_Furniture_Lamp002_Desc"	"O lampă simplă."
"[english]VR_Furniture_Lamp002_Desc"	"A simple lamp."
"VR_Furniture_Jar001"	"Borcan"
"[english]VR_Furniture_Jar001"	"Jar"
"VR_Furniture_Jar001_Desc"	"Un borcan."
"[english]VR_Furniture_Jar001_Desc"	"A jar."
"ItemDetail_SetBackground"	"Setează fundalul"
"[english]ItemDetail_SetBackground"	"Set Background"
"ItemDetail_EquipTool"	"Echipează"
"[english]ItemDetail_EquipTool"	"Equip"
"AvatarTutorialTitle"	"Cum să-ți personalizezi avatarul"
"[english]AvatarTutorialTitle"	"How to Customize Your Avatar"
"AvatarTutorialButton"	"Cum să"
"[english]AvatarTutorialButton"	"How To"
"RecentApps_Title"	"APLICAȚII RECENTE"
"[english]RecentApps_Title"	"RECENT APPS"
"RecentApps_Footer"	"Pentru toate aplicațiile, apasă butonul System."
"[english]RecentApps_Footer"	"For all applications, press the System button."
"VR_Furniture_Bench001"	"Bancă"
"[english]VR_Furniture_Bench001"	"Bench"
"VR_Furniture_Bench001_Desc"	"O bancă."
"[english]VR_Furniture_Bench001_Desc"	"A bench."
"VR_Furniture_Statue001_Desc"	"O statuie."
"[english]VR_Furniture_Statue001_Desc"	"A statue."
"VR_PropTool_BoxBot_Desc"	"
"
"[english]VR_PropTool_BoxBot_Desc"	""
"DismissLabel"	"Nu acum"
"[english]DismissLabel"	"Not Now"
"ItemDetail_HostNewRoom"	"Găzduiește o cameră"
"[english]ItemDetail_HostNewRoom"	"Host a Room"
"BrowseWorkshop_ViewInMenu"	"Vezi în meniu"
"[english]BrowseWorkshop_ViewInMenu"	"View in Menu"
"HostMessageTitle"	"Ce tip de cameră?"
"[english]HostMessageTitle"	"What kind of Room?"
"CancelHostText"	"Anulează"
"[english]CancelHostText"	"Cancel"
"VisitMessageTitle"	"Ce versiune?"
"[english]VisitMessageTitle"	"Which version?"
"Friends_InGame_VR"	"În joc - VR"
"[english]Friends_InGame_VR"	"In Game - VR"
"Friends_App_Title"	"{s:in_app_name}"
"[english]Friends_App_Title"	"{s:in_app_name}"
"GameUI_Disconnect_ConnectionTimedout"	"Alăturarea la cameră a expirat"
"[english]GameUI_Disconnect_ConnectionTimedout"	"Timed out trying to join room"
"UGCTitle"	"COMUNITATEA STEAM"
"[english]UGCTitle"	"STEAM COMMUNITY"
"ScreenshotTabText"	"CAPTURI DE ECRAN"
"[english]ScreenshotTabText"	"SCREENSHOTS"
"ArtworkTabText"	"ILUSTRAȚII"
"[english]ArtworkTabText"	"ARTWORK"
"ScreenshotNumber"	"{d:max_publishedfileid}"
"[english]ScreenshotNumber"	"{d:max_publishedfileid}"
"SteamPlayerNumber"	"{d:current_player_count}"
"[english]SteamPlayerNumber"	"{d:current_player_count}"
"VRTitleLabel"	"{s:app_name}"
"[english]VRTitleLabel"	"{s:app_name}"
"HTCPromoTitle"	"MEDIU VIVE"
"[english]HTCPromoTitle"	"VIVE ENVIRONMENT"
"UGCItem_Creator"	"{s:creator_name}"
"[english]UGCItem_Creator"	"{s:creator_name}"
"UGCItem_Title_Text"	"De la:"
"[english]UGCItem_Title_Text"	"From:"
"UGCItem_Title"	"{s:item_text}"
"[english]UGCItem_Title"	"{s:item_text}"
"DetailsButtonText"	"Detalii"
"[english]DetailsButtonText"	"Details"
"CancelButtonText"	"Anulează"
"[english]CancelButtonText"	"Cancel"
"ShowAllAppsText"	"Vezi toate aplicațiile"
"[english]ShowAllAppsText"	"View All Applications"
"WorldPublicLobbyTitle"	"CAMERE"
"[english]WorldPublicLobbyTitle"	"ROOMS"
"VRHome_Patio_Title"	"SE SALVEAZĂ"
"[english]VRHome_Patio_Title"	"SAVING"
"VRHome_Config_Previous"	"ÎNAPOI"
"[english]VRHome_Config_Previous"	"PREVIOUS"
"VRHome_Config_Next"	"CONTINUĂ"
"[english]VRHome_Config_Next"	"NEXT"
"VRHome_Config_Default"	"IMPLICIT"
"[english]VRHome_Config_Default"	"DEFAULT"
"VRHome_Config_Bedroom"	"DORMITOR"
"[english]VRHome_Config_Bedroom"	"BEDROOM"
"VRHome_Sky_Default"	"IMPLICIT"
"[english]VRHome_Sky_Default"	"DEFAULT"
"VRHome_Patio_Default"	"IMPLICIT"
"[english]VRHome_Patio_Default"	"DEFAULT"
"VRHome_Patio_Statue"	"STATUIE"
"[english]VRHome_Patio_Statue"	"STATUE"
"VRHome_Patio_Bar"	"BAR"
"[english]VRHome_Patio_Bar"	"BAR"
"ContentBrowser_ItemDesc"	"{s:description}"
"[english]ContentBrowser_ItemDesc"	"{s:description}"
"ItemDetail_Ratings"	"Evaluări"
"[english]ItemDetail_Ratings"	"Ratings"
"ItemDetail_Rating"	"Evaluare"
"[english]ItemDetail_Rating"	"Rating"
"Friends_Name"	"{s:name}"
"[english]Friends_Name"	"{s:name}"
"Friends_NickName"	"({s:nickname})"
"[english]Friends_NickName"	"({s:nickname})"
"WelcomePanel_UpdateText"	"{s:workshop_title}"
"[english]WelcomePanel_UpdateText"	"{s:workshop_title}"
"ResetButtonText"	"Resetează poziția"
"[english]ResetButtonText"	"Reset Position"
"BrowseWorkshop_Visit"	"Vizitează"
"[english]BrowseWorkshop_Visit"	"Visit"
"VR_Avatar_keemo_head"	"Keemo"
"[english]VR_Avatar_keemo_head"	"Keemo"
"VR_Avatar_keli_head"	"Keli"
"[english]VR_Avatar_keli_head"	"Keli"
"VR_Avatar_mochi_head"	"Mochi"
"[english]VR_Avatar_mochi_head"	"Mochi"
"VR_Avatar_teemo_head"	"Teemo"
"[english]VR_Avatar_teemo_head"	"Teemo"
"VR_PhysicsProp_NekoPlushie"	"Jucărie Neko"
"[english]VR_PhysicsProp_NekoPlushie"	"Neko Toy"
"VR_PhysicsProp_NekoPlushie_Desc"	"Miau, miau, miau, miau.\n\nDeblocat după ce ai jucat Fantastic Contraption."
"[english]VR_PhysicsProp_NekoPlushie_Desc"	"Meow meow meow meow.\n\nUnlocked by playing Fantastic Contraption."
"VR_PhysicsProp_ASAmmoBox"	"Muniție"
"[english]VR_PhysicsProp_ASAmmoBox"	"Ammo Box"
"VivePromoTitle"	"Obiecte Vive"
"[english]VivePromoTitle"	"Vive Items"
"VR_PhysicsProp_Island359TRexFigurine"	"T-Rex"
"[english]VR_PhysicsProp_Island359TRexFigurine"	"T-Rex"
"ItemDetail_Type_Collectible"	"Obiect de colecție SteamVR"
"[english]ItemDetail_Type_Collectible"	"SteamVR Collectible"
"GameTrophy_AppName"	"{s:app_name}"
"[english]GameTrophy_AppName"	"{s:app_name}"
"GameTrophy_OwnerName"	"{s:owner_name}"
"[english]GameTrophy_OwnerName"	"{s:owner_name}"
"GameTrophy_Playtime"	"Timp jucat: {t:d:t:playtime}"
"[english]GameTrophy_Playtime"	"Playtime:  {t:d:t:playtime}"
"GameTrophy_BadgeLevel"	"Nivelul insignei: {d:badge_level}"
"[english]GameTrophy_BadgeLevel"	"Badge Level:  {d:badge_level}"
"GameTrophy_Achievements_Label"	"REALIZĂRI {d:num_achievements_completed}/{d:num_achievements} "
"[english]GameTrophy_Achievements_Label"	"ACHIEVEMENTS {d:num_achievements_completed}/{d:num_achievements} "
"GameTrophy_Achievements"	"{d:num_achievements_completed} din {d:num_achievements} realizări"
"[english]GameTrophy_Achievements"	"{d:num_achievements_completed} of {d:num_achievements} Achievements"
"GameTrophy_PlayButton"	"Joacă"
"[english]GameTrophy_PlayButton"	"Play"
"GameTrophy_CloseButton"	"Închide"
"[english]GameTrophy_CloseButton"	"Close"
"VR_GameTrophy_NoAchievements"	"Un trofeu Steam"
"[english]VR_GameTrophy_NoAchievements"	"A Steam Trophy"
"VR_GameTrophy_NoAchievements_Desc"	"Un trofeu Steam pentru {s:app_name}."
"[english]VR_GameTrophy_NoAchievements_Desc"	"A Steam Trophy for {s:app_name}."
"ContentBrowser_Things_Tools"	"Instrumente"
"[english]ContentBrowser_Things_Tools"	"Tools"
"ContentBrowser_Things_Wearables"	"Accesorii de purtat"
"[english]ContentBrowser_Things_Wearables"	"Wearables"
"ContentBrowser_Things_Furniture"	"Mobilier"
"[english]ContentBrowser_Things_Furniture"	"Furniture"
"ContentBrowser_Things_Trophies"	"Trofee"
"[english]ContentBrowser_Things_Trophies"	"Trophies"
"BrowseThingsTitle"	"Lucruri"
"[english]BrowseThingsTitle"	"Things"
"BrowseToolsTitle"	"Instrumente"
"[english]BrowseToolsTitle"	"Tools"
"BrowseWearablesTitle"	"Accesorii de purtat"
"[english]BrowseWearablesTitle"	"Wearables"
"BrowseFurnitureTitle"	"Mobilier"
"[english]BrowseFurnitureTitle"	"Furniture"
"BrowseTrophiesTitle"	"Trofee"
"[english]BrowseTrophiesTitle"	"Trophies"
"GameTrophy_BadgeName"	"{s:badge_name}"
"[english]GameTrophy_BadgeName"	"{s:badge_name}"
"GameTrophy_Normal_BadgeLevel"	"NIVELUL INSIGNEI: {d:badge_level}"
"[english]GameTrophy_Normal_BadgeLevel"	"BADGE LEVEL {d:badge_level}"
"GameTrophy_Foil_BadgeLevel"	"NIVELUL INSIGNEI ÎNFOLIATE: {d:badge_level}"
"[english]GameTrophy_Foil_BadgeLevel"	"FOIL BADGE LEVEL {d:badge_level}"
"GameTrophy_Screenshots_Label"	"CAPTURI DE ECRAN: "
"[english]GameTrophy_Screenshots_Label"	"SCREENSHOTS: "
"VR_GameTrophy_Bronze"	"Un trofeu Steam de bronz"
"[english]VR_GameTrophy_Bronze"	"A Bronze Steam Trophy"
"VR_GameTrophy_Bronze_Desc"	"Un trofeu Steam de bronz pentru {s:app_name}."
"[english]VR_GameTrophy_Bronze_Desc"	"A Bronze Steam Trophy for {s:app_name}."
"VR_GameTrophy_Silver"	"Un trofeu Steam de argint"
"[english]VR_GameTrophy_Silver"	"A Silver Steam Trophy"
"VR_GameTrophy_Silver_Desc"	"Un trofeu Steam de argint pentru {s:app_name}."
"[english]VR_GameTrophy_Silver_Desc"	"A Silver Steam Trophy for {s:app_name}."
"VR_GameTrophy_Gold"	"Un trofeu Steam de aur"
"[english]VR_GameTrophy_Gold"	"A Gold Steam Trophy"
"VR_GameTrophy_Gold_Desc"	"Un trofeu Steam de aur pentru {s:app_name}."
"[english]VR_GameTrophy_Gold_Desc"	"A Gold Steam Trophy for {s:app_name}."
"VR_GameTrophy_Platinum"	"Un trofeu Steam de platină"
"[english]VR_GameTrophy_Platinum"	"A Platinum Steam Trophy"
"VR_GameTrophy_Platinum_Desc"	"Un trofeu Steam de platină pentru {s:app_name}."
"[english]VR_GameTrophy_Platinum_Desc"	"A Platinum Steam Trophy for {s:app_name}."
"SpawnablePanel_RecentApps"	"Aplicații recente"
"[english]SpawnablePanel_RecentApps"	"Recent Apps"
"SpawnablePanel_Friends"	"Prieteni Steam"
"[english]SpawnablePanel_Friends"	"Steam Friends"
"SpawnablePanel_PublicLobbies"	"Camere"
"[english]SpawnablePanel_PublicLobbies"	"Rooms "
"ContentBrowser_Things_SpawnablePanels"	"Panouri"
"[english]ContentBrowser_Things_SpawnablePanels"	"Panels"
"BrowseSpawnablePanelsTitle"	"Panouri"
"[english]BrowseSpawnablePanelsTitle"	"Panels"
"VR_PhysicsProp_LocodojoSensei"	"Grand Sensei"
"[english]VR_PhysicsProp_LocodojoSensei"	"Grand Sensei"
"VR_PhysicsProp_LocodojoSensei_Desc"	"Grand Sensei este maestrul de ceremonii de la Loco Dojo.\n\nDeblocat pentru că ai jucat Loco Dojo."
"[english]VR_PhysicsProp_LocodojoSensei_Desc"	"The Grand Sensei is Loco Dojo's master of ceremonies.\n\nUnlocked by playing Loco Dojo."
"VR_Avatar_Wearable_HalloweenBagMask001_Desc"	"O opțiune simplă și ieftină pentru un costum de Halloween."
"[english]VR_Avatar_Wearable_HalloweenBagMask001_Desc"	"A simple cheap option for a Halloween costume."
"ContentBrowser_Things_Screenshots"	"Capturi de ecran"
"[english]ContentBrowser_Things_Screenshots"	"Screenshots"
"ContentBrowser_Things_Artwork"	"Ilustrații"
"[english]ContentBrowser_Things_Artwork"	"Artwork"
"BrowseScreenshotsTitle"	"Capturi de ecran"
"[english]BrowseScreenshotsTitle"	"Screenshots"
"BrowseArtworkTitle"	"Ilustrații"
"[english]BrowseArtworkTitle"	"Artwork"
"ScreenshotDetailTitle"	"Captură de ecran"
"[english]ScreenshotDetailTitle"	"Screenshot"
"ArtworkDetailTitle"	"Ilustrații"
"[english]ArtworkDetailTitle"	"Artwork"
"Artwork_MyTab_Label"	"Ilustrațiile mele"
"[english]Artwork_MyTab_Label"	"My Artwork"
"Screenshots_MyTab_Label"	"Capturile mele de ecran"
"[english]Screenshots_MyTab_Label"	"My Screenshots"
"BoxingRing_ScorePlayer"	"JUCĂTOR"
"[english]BoxingRing_ScorePlayer"	"PLAYER"
"BoxingRing_ScorePlayerWins"	"AI CÂȘTIGAT!"
"[english]BoxingRing_ScorePlayerWins"	"YOU WIN!"
"VR_Avatar_Wearable_HalloweenBagMask002_Desc"	"O opțiune simplă și ieftină pentru un costum de Halloween."
"[english]VR_Avatar_Wearable_HalloweenBagMask002_Desc"	"A simple cheap option for a Halloween costume."
"VR_Avatar_Wearable_HalloweenBagMask003_Desc"	"O opțiune simplă și ieftină pentru un costum de Halloween."
"[english]VR_Avatar_Wearable_HalloweenBagMask003_Desc"	"A simple cheap option for a Halloween costume."
"VR_Avatar_Wearable_HalloweenBagMask004_Desc"	"O opțiune simplă și ieftină pentru un costum de Halloween."
"[english]VR_Avatar_Wearable_HalloweenBagMask004_Desc"	"A simple cheap option for a Halloween costume."
"VR_Avatar_Wearable_HalloweenBagMask005_Desc"	"O opțiune simplă și ieftină pentru un costum de Halloween."
"[english]VR_Avatar_Wearable_HalloweenBagMask005_Desc"	"A simple cheap option for a Halloween costume."
"VR_Avatar_Wearable_HalloweenBagMask006_Desc"	"O opțiune simplă și ieftină pentru un costum de Halloween."
"[english]VR_Avatar_Wearable_HalloweenBagMask006_Desc"	"A simple cheap option for a Halloween costume."
"VR_Avatar_Wearable_HalloweenBagMask007_Desc"	"O opțiune simplă și ieftină pentru un costum de Halloween."
"[english]VR_Avatar_Wearable_HalloweenBagMask007_Desc"	"A simple cheap option for a Halloween costume."
"VR_Avatar_Wearable_HalloweenBagMask008_Desc"	"O opțiune simplă și ieftină pentru un costum de Halloween."
"[english]VR_Avatar_Wearable_HalloweenBagMask008_Desc"	"A simple cheap option for a Halloween costume."
"VR_Avatar_Wearable_HalloweenBagMask009_Desc"	"O opțiune simplă și ieftină pentru un costum de Halloween."
"[english]VR_Avatar_Wearable_HalloweenBagMask009_Desc"	"A simple cheap option for a Halloween costume."
"VR_Avatar_Wearable_HalloweenBagMask010_Desc"	"O opțiune simplă și ieftină pentru un costum de Halloween."
"[english]VR_Avatar_Wearable_HalloweenBagMask010_Desc"	"A simple cheap option for a Halloween costume."
"VR_Avatar_Wearable_HalloweenBagMask011_Desc"	"O opțiune simplă și ieftină pentru un costum de Halloween."
"[english]VR_Avatar_Wearable_HalloweenBagMask011_Desc"	"A simple cheap option for a Halloween costume."
"VR_Avatar_Wearable_HalloweenBagMask012_Desc"	"O opțiune simplă și ieftină pentru un costum de Halloween."
"[english]VR_Avatar_Wearable_HalloweenBagMask012_Desc"	"A simple cheap option for a Halloween costume."
"VR_Avatar_Wearable_HalloweenBagMask013_Desc"	"O opțiune simplă și ieftină pentru un costum de Halloween."
"[english]VR_Avatar_Wearable_HalloweenBagMask013_Desc"	"A simple cheap option for a Halloween costume."
"VR_Avatar_Wearable_HalloweenBagMask014_Desc"	"O opțiune simplă și ieftină pentru un costum de Halloween."
"[english]VR_Avatar_Wearable_HalloweenBagMask014_Desc"	"A simple cheap option for a Halloween costume."
"VR_PhysicsProp_TrafficCone001"	"Con de trafic"
"[english]VR_PhysicsProp_TrafficCone001"	"Traffic Cone"
"VR_PhysicsProp_GoogleEarthGlobe"	"Globul Google Earth"
"[english]VR_PhysicsProp_GoogleEarthGlobe"	"Google Earth Globe"
"VR_PhysicsProp_KatanaX"	"Katana X"
"[english]VR_PhysicsProp_KatanaX"	"The Katana X"
"VR_PhysicsProp_RacketNxFigurine"	"Avatar RNX"
"[english]VR_PhysicsProp_RacketNxFigurine"	"RNX Avatar"
"VR_Avatar_DuckHuntDogHead"	"Cap de câine"
"[english]VR_Avatar_DuckHuntDogHead"	"Dog Head"
"VR_Avatar_Wearable_GornWingedHelmet"	"Cască înaripată"
"[english]VR_Avatar_Wearable_GornWingedHelmet"	"Winged Helmet"
"VR_Avatar_WindowsMR_Controllers"	"Controllere Windows MR"
"[english]VR_Avatar_WindowsMR_Controllers"	"Windows MR Controllers"
"VR_Avatar_WindowsMR_Controllers_Desc"	"Controllere Windows MR"
"[english]VR_Avatar_WindowsMR_Controllers_Desc"	"Windows MR controllers"
"TutorialWelcome_Tile1_WinMR_Desc"	"Bine ai venit în SteamVR!"
"[english]TutorialWelcome_Tile1_WinMR_Desc"	"Welcome to SteamVR!"
"TutorialWelcome_Tile2_WinMR_Desc"	"În SteamVR poți vizita locuri adevărate și imaginare împreună cu prietenii tăi."
"[english]TutorialWelcome_Tile2_WinMR_Desc"	"In SteamVR you can visit real and imaginary places with friends."
"TutorialWelcome_Tile3_WinMR_Desc"	"Pentru a deschide și a închide acest meniu, utilizează butonul de meniu de pe controllerul tău."
"[english]TutorialWelcome_Tile3_WinMR_Desc"	"To open and close this menu, use the menu button on your controller."
"TutorialTeleport_Tile1_WinMR_Desc"	"Pentru a te teleporta, apasă înainte pe joystick."
"[english]TutorialTeleport_Tile1_WinMR_Desc"	"To teleport, push forward on the joystick."
"TutorialTeleport_Tile2_WinMR_Desc"	"Vei vedea un arc care se sfârșește cu un cerc verde pe sol."
"[english]TutorialTeleport_Tile2_WinMR_Desc"	"You will see an arc that ends with a green circle on the ground."
"TutorialTeleport_Tile3_WinMR_Desc"	"Dă drumul la joystick pentru a te teleporta la cercul verde."
"[english]TutorialTeleport_Tile3_WinMR_Desc"	"Release the joystick to teleport to the green circle."
"TutorialTeleport_WinMR_Bottom_Desc"	"Arcul teleportării se va face roșu dacă nu te poți teleporta la acea locație."
"[english]TutorialTeleport_WinMR_Bottom_Desc"	"The teleport arc will turn red if you cannot teleport to that location."
"VR_PhysicsProp_TiltBrushTiltasaurus"	"Tiltasaurus"
"[english]VR_PhysicsProp_TiltBrushTiltasaurus"	"Tiltasaurus"
"VR_PhysicsProp_TF2Yeti"	"Yeti"
"[english]VR_PhysicsProp_TF2Yeti"	"Yeti"
"VR_PhysicsProp_DeservingLifePizza"	"Pizza e viață!"
"[english]VR_PhysicsProp_DeservingLifePizza"	"Pizza is Life!"
"VR_PhysicsProp_WrathOfLokiHammer"	"Ciocanul lui Thor"
"[english]VR_PhysicsProp_WrathOfLokiHammer"	"Thor's Hammer"
"VR_PhysicsProp_WrathOfLokiHammer_Desc"	"Un ciocan pe măsura unui zeu.\n\nDeblocat după ce ai jucat Wrath of Loki VR Adventure."
"[english]VR_PhysicsProp_WrathOfLokiHammer_Desc"	"A hammer fit for a god.\n\nUnlocked by playing Wrath of Loki VR Adventure."
"ScreenshotTutorialButton"	"Ajutor"
"[english]ScreenshotTutorialButton"	"Help"
"ScreenshotTutorialTitle"	"Cum să realizezi capturi de ecran în SteamVR"
"[english]ScreenshotTutorialTitle"	"How to Take Screenshots in SteamVR"
"ScreenshotTutorialVive"	"Pentru a face o captură de ecran în timp ce te afli în joc, apasă pe butoanele System și Trigger în același timp.\n\nOdată ce ai ieșit din joc, îți va fi prezentată interfața de administrare a capturilor de ecran Steam, unde vei putea să îți împărtășești public capturile de ecran."
"[english]ScreenshotTutorialVive"	"To take a screenshot while in a game, press the System and Trigger buttons at the same time.\n\nOnce you've quit the game, you will be presented with the Steam Screenshot Manager interface, where you’ll be able to share the screenshots publicly."
"ScreenshotTutorialWinMR"	"Pentru a face o captură de ecran în timp ce te afli în joc, apasă pe stickul analog stâng și pe butonul Trigger în același timp.\n\nOdată ce ai ieșit din joc, îți va fi prezentată interfața de administrare a capturilor de ecran Steam, unde vei putea să îți împărtășești public capturile de ecran."
"[english]ScreenshotTutorialWinMR"	"To take a screenshot while in a game, press the Left Thumbstick and Trigger buttons at the same time.\n\nOnce you've quit the game, you will be presented with the Steam Screenshot Manager interface, where you’ll be able to share the screenshots publicly."
"ScreenshotTutorialVTouch"	"Pentru a face o captură de ecran în timp ce te afli în joc, apasă pe butoanele Left Menu și Trigger în același timp.\n\nOdată ce ai ieșit din joc, îți va fi prezentată interfața de administrare a capturilor de ecran Steam, unde vei putea să îți împărtășești public capturile de ecran."
"[english]ScreenshotTutorialVTouch"	"To take a screenshot while in a game, press the Left Menu and Trigger buttons at the same time.\n\nOnce you've quit the game, you will be presented with the Steam Screenshot Manager interface, where you’ll be able to share the screenshots publicly."
}
}
